item_id,item_desc,p_up,p_down,p_level,region,p_ch,p,p_r
210102,LARGE LOAF-WHITE-UNSLICED-800G,4,59,51,114,-.026290089,1.1,1.20035
210106,SIX BREAD ROLLS-WHITE/BROWN,15,71,61,147,-.01380673,.80000001,.80000001
210111,WHITE SLICED LOAF BRANDED 750G,38,64,47,149,0,1.1,1.0527
210113,WHOLEMEAL SLICED LOAF BRANDED,55,48,45,148,0,.99000001,.99659997
210114,CHILLED GARLIC BREAD,66,25,151,242,0,.89999998,.89999998
210201,FLOUR-SELF-RAISING-1.5KG,73,3,70,146,.068387017,.60000002,.56060004
210204,DRY SPAGHETTI OR PASTA 500G,45,74,123,242,0,.60000002,.62064999
210211,CORN SNACK SINGLE PACK MAX 50G,49,21,57,127,0,.85000002,.84745002
210212,BASMATI RICE 500G-1KG,23,54,71,148,0,1.6,1.6511999
210213,BREAKFAST CEREAL 1,42,102,98,242,0,2.8,2.8814001
210214,BREAKFAST CEREAL 2,42,94,106,242,0,1.9,1.9
210215,CEREAL BAR,73,27,138,238,0,.25,.2
210216,HOT OAT CEREAL,28,81,116,225,0,1.99,1.98
210217,RICE MICRO POUCH/TRAY 220-280G,34,40,166,240,0,.99000001,.99000001
210218,"POPCORN, BAG, 10-30G",55,28,130,213,0,.30000001,.30000001
210219,BREAKFAST CEREAL GLUTEN FREE,17,91,106,214,0,1.95,1.97505
210221,COUSCOUS PLAIN/FLAVOURED,21,4,149,174,0,.69999999,.67400002
210301,CREAM CRACKERS PACK 200G-300G,40,27,82,149,0,1,1
210302,PLAIN BISCUITS-200-300G,14,90,46,150,-.032882083,1,1
210319,DOUGHNUT-EACH,27,58,49,134,0,.22499999,.22571999
210320,WHOLE SPONGE CAKE NOT FROZEN,45,38,64,147,0,1.6900001,1.5879899
210321,PACK OF 5-6 INDIVIDUAL CAKES,35,70,38,143,-.032878414,1.6,1.4450001
210323,BISCUITS HALF CHOC 260-400G,67,32,145,244,0,1.35,1.239975
210324,CRUMPETS PACK 6-9 SPEC NUMBER,94,29,103,226,0,.89999998,.89999998
210403,HOME KILLED BEEF-LEAN MINCE KG,91,73,105,269,0,6.4899998,6.0112
210406,HOME KLD BEEF-RUMP/POPES STEAK,32,106,128,266,0,15.505,16.065001
210414,FROZEN BEEFBURGERS PACK OF 4,31,27,85,143,0,2.49,2.0825
210416,BEEF ROASTING JOINT PER KG,55,76,115,246,0,11,10.996
210506,HK LAMB LOIN CHOP/STEAK PER KG,47,171,140,358,-.0089196609,13.86,14.3186
210507,HOME KILLED LAMB SHOULDER KG,12,102,132,246,-.023437573,8.7749996,9.0822506
210703,HOME KILLED PORK-LOIN CHOPS KG,23,66,151,240,0,6.4749999,6.5398302
210802,BACON-GAMMON-PER KG,53,69,139,261,0,7,7
210808,BACON-BACK-PER KG,92,70,113,275,0,7.3000002,7.71
210905,FRESH/CHILLED CHICKEN  PER KG,42,123,86,251,-.0059632137,2.79,2.8299999
210910,FRESH BONELESS CHICKEN BREAST,67,83,117,267,0,6.3499999,6.3580003
210913,ROTISSERIE CHICKEN [WHOLE],0,36,8,44,-.011857696,5,5.1101999
210914,FRESH TURKEY DICED/MIN PER KG,4,36,32,72,-.023414262,6.8000002,7.1128001
211007,CANNED MEAT-STEWED STEAK,25,37,80,142,0,2.45,2.45
211011,INDIVIDUAL MEAT PIE,49,73,141,263,0,1.35,1.38
211014,SAUSAGES-PORK-PER KG,57,90,129,276,0,5.5,5.8070602
211019,FROZ CHICKEN NUGGETS 220-600G,30,17,98,145,0,1.5,1.5
211023,COOKED HAM PREPACKED SLICED,65,21,89,175,0,2,2
211024,CONTINENTAL SLICED DELI MEAT,24,21,123,168,0,2.0999999,1.8009999
211025,JOINT OV/READ GAM/POR 450-900G,50,17,92,159,0,5,4.6900001
211026,CHICKEN KIEV 2 PACK 240-325G,45,87,100,232,0,2,2.116725
211027,H K LIVER PER KG STATE TYPE,16,74,56,146,-.0099010011,2.5,2.5349998
211029,COOKED MEAT TURKEY/CHICK SLICE,78,112,158,348,0,1.75,1.784
211030,MEAT BASED SNACK PACK MAX 400G,29,63,149,241,0,1.75,1.75
211031,COOKED HAM LOOSE PER 100G,51,26,61,138,0,1.55,1.63151
211101,FRESH WHITE FISH FILLETS KG,12,62,73,147,0,15,15
211105,FRESH FISH-SALMON FILLETS-KG,85,17,44,146,.020408124,14.805,13.870079
211106,FROZEN PRAWNS PER KG,60,22,91,173,0,15.28,13.75
211207,"CANNED FISH, TUNA, 130G-200G",25,54,57,136,0,.89999998,.95309997
211210,FROZEN FISH FINGERS 8-12 PK,71,75,97,243,0,2.5,1.9225
211211,FROZEN BREAD/BAT FISH 400-550G,63,60,119,242,0,3.5999999,3.5999999
211305,SPREADABLE BUTTER,46,103,92,241,0,3.25,3.25
211306,BUTTER 250G SPEC COO,83,24,135,242,0,1.7,1.6898
211407,MARGARINE/LOW FAT SPREAD-500G,18,109,21,148,-.20823437,1.75,1.9704001
211408,OLIVE OIL - 500ML - 1 LITRE,23,79,138,240,0,3.4000001,3.4000001
211409,"PEANUT BUTTER, JAR, 225-350G",54,67,131,252,0,2.0699999,1.75
211501,CHEDDAR-HOME PRODUCED PER KG,69,22,57,148,0,5.6700001,5.4742751
211506,"CHEESE SPREAD, 125g-200g TUB",26,55,46,127,0,1,1.053
211509,HARD REGIONAL CHEESE PER KG,60,20,65,145,0,7.0500002,7.0500002
211510,PARMESAN CHEESE-PER KG,15,57,70,142,0,17.65,17.65
211511,SOFT CONTINENTAL CHEESE - KG,96,48,91,235,0,7.5,7.5
211602,EGGS-MEDIUM-PER DOZ OR 2 X 6,25,64,48,137,0,1.78,1.85654
211603,EGGS-LARGE-PER DOZ OR 2 X 6,9,75,61,145,-.0049751196,2.2,2.25
211709,SHOP MILK-WHOLE MILK-4PT/2LTR,73,44,127,244,0,1.09,1.102535
211710,MILK SEMI-PER 2 PINTS/1.136 L,38,25,84,147,0,.80000001,.80000001
211713,"MILK FLAVOURED, 180-500MLS/GMS",43,26,156,225,0,1.15,1.15
211714,NON-DAIRY MILK DRINK 900ML-1LT,27,125,92,244,-.051681343,1.5,1.5
211807,"YOGHURT/FROMAGE 4-6PK, 45-125G",23,76,47,146,-.052581467,1.3,1.5
211808,CHILLED POT DESSERT 125-200G,36,38,85,159,0,.68000001,.68000001
211814,YOGHURT-SMALL INDIVIDUAL,36,22,88,146,0,.60000002,.62395501
211815,FRESH DOUBLE CREAM 250ML-300ML,33,25,89,147,0,1.1,1.1
211816,POWDERED BABY FORMULA 400-900G,19,143,64,226,-.030067861,10.75,10.75
211901,TEA BAGS PKT OF 80 (230G-250G),31,41,76,148,0,2,2
211904,TEA BAGS-2-PACKET OF 240,36,46,89,171,0,3.5,3.49
211905,"FLAVRD TEA 15-20 BAGS, 30-40G",43,29,164,236,0,1.7,1.7
212001,"FRUIT SQUASH, 750ML - 1.5LT",93,39,110,242,0,1.25,1.25
212006,FRUIT JUICE NOT ORANGE 1L,44,40,62,146,0,.89999998,.89999998
212008,LEMONADE-2 LITRE BOTTLE,67,12,67,146,0,.5,.40000001
212010,MINERAL WATER STILL 1.5-2L,83,17,122,222,.016260128,.5,.44420001
212015,FIZZY ENERGY DRINK 250-500ML,38,74,48,160,-.00049952924,1.45,1.4926
212016,FRESH/CHILL ORANGE JUICE 900ML,93,17,39,149,.060445335,1.75,1.392
212017,FIZZY BOTTLED DRINK 500ML,55,74,21,150,-.0049750805,1.45,1.50035
212020,FRUIT DRINK BOTTLE 4-8 PACK,10,126,87,223,-.12510936,2,2
212021,BOTTLE STILL WATER 500ML,70,37,139,246,0,.35500002,.33175001
212022,MIXER DRINK BOTTLE 1L EG TONIC,46,45,152,243,0,.60000002,.68599999
212023,COLA/FIZZY DRINK 330ML PK 4-8,51,106,69,226,0,3,3.5362501
212024,FLAVOURED WATER BOTT 900ML-1.5,45,84,113,242,0,.60000002,.60025001
212025,"COLA DRINK, REG,BOTTLE,1.25-2L",87,25,124,236,0,1.9,1.9
212026,"COLA DRINK, DIET 1.25-2LTR",115,31,95,241,0,1.5,1.4070001
212027,FRUIT/VEG SMOOTHIE,49,42,83,174,0,2,1.9
212101,SUGAR -GRANULATED-WHITE-PER KG,67,15,159,241,0,.69999999,.69069004
212106,JAR OF JAM-340-454G,39,44,60,143,0,.85000002,.85000002
212107,HONEY JAR/BOTTLE 340G-454G,46,86,108,240,0,2.0999999,2.2049997
212202,MINTS,27,22,86,135,0,.64999998,.65390003
212211,CHOCOLATE 4,27,30,83,140,0,.69999999,.69999999
212214,FRUIT PASTILLES 2,20,52,54,126,0,.64999998,.67010999
212217,CHEWING/BUBBLE GUM-SINGLE PK,16,71,57,144,-.012833171,.60000002,.60000002
212218,CARTON/BOX OF CHOCS 150-400GM,43,27,52,122,0,4.4949999,4.1407952
212222,CHOCOLATE 10,46,37,36,119,0,.69999999,.68625003
212223,BRAND CHOC SWEETS 90-185G BAG,73,48,100,221,0,1,1.01545
212224,"SWEETS, NOT CHOC, 150-250G BAG",112,31,78,221,.023541456,1,.94400001
212225,CHOCOLATE LARGE BAR 100-200G,85,31,96,212,0,1.45,1.4260751
212226,CHOCOLATE 12,31,88,84,203,0,.60000002,.59400004
212228,MALTED CHOCOLATE SWEETS,128,15,19,162,.090512551,.60000002,.54540002
212309,POTATOES-NEW-PER KG,195,192,140,527,0,1.3200001,1.2961799
212310,POTATOES- OLD WHITE PER KG,232,145,160,537,0,.47999999,.53760004
212311,POTATOES- BAKING PR KG,80,227,168,475,-.016715799,.80000001,.80000001
212402,POTATO CRISPS 25G-50G,12,154,84,250,-.021525498,.85000002,.89999998
212404,POTATO CRISPS-MULTI-PACK,32,156,200,388,0,1.5,1.5
212405,FROZEN CHIPS 900G-1.5KG,64,132,195,391,0,1.8,2.0423901
212408,PREMIUM POTATO CRISPS/CHIPS,92,36,34,162,.0080645429,1.3200001,1.30944
212409,P'PARED MASHED POTATO 400-650G,148,50,161,359,0,1,1
212504,FRESH VEG-CAULIFLOWER-EACH,140,220,199,559,0,.89999998,1
212510,FRESH VEG-CUCUMBER-WHOLE,238,150,176,564,0,.55000001,.51727498
212511,FRESH VEG-LETTUCE-ICEBERG-EACH,262,122,154,538,.0070493566,.43000001,.43000001
212515,FRESH VEG-TOMATOES-PER KG,315,96,106,517,.010101049,2.1800001,2.1538401
212516,FRESH VEG-CABBAGE-WHOLE-PER KG,127,176,228,531,0,.75,.75
212518,FRESH VEG-CARROTS-PER KG,216,236,96,548,0,.5,.51999998
212519,FRESH VEG-ONIONS-PER KG,78,297,168,543,-.012833152,.85000002,.86699998
212520,FRESH VEG-MUSHROOMS-PER KG,151,198,202,551,0,3.1700001,3.3200099
212527,PRE-PACKED SALAD 100-250G,41,14,93,148,0,1,1.04125
212530,FRESH VEG-BROCCOLI-PER KG,164,206,166,536,0,1.75,1.75
212531,FRESH VEG-COURGETTE-PER KG,162,196,184,542,0,2.1500001,2.036
212532,FRESH VEG-PEPPERS -LOOSE OR KG,217,238,91,546,0,.47999999,.498
212533,VEGETABLE STIR FRY FRESH PACK,23,16,213,252,0,1.2,1.2
212535,SWEET POTATO PER KG OR EACH,278,133,216,627,0,1.1,1.1
212601,CANNED TOMATOES 390-400G,41,303,47,391,-.11111107,.44999999,.50624996
212603,"BAKED BEANS, 400-420G TIN",73,93,222,388,0,.85000002,.85000002
212608,CANNED SWEETCORN 198-340G,15,177,86,278,-.032882042,.75,.80324996
212609,FROZEN GARDEN PEAS 800G-1KG,89,35,166,290,0,1,1
212612,FROZEN PRE-PREPARED VEGTABLES,98,54,229,381,0,1,1
212709,ORANGES-CLASS 1-EACH,112,233,190,535,0,.38999999,.39649999
212710,AVOCADO PEAR-EACH,156,312,75,543,-.060150396,.85000002,.95099998
212712,KIWI FRUIT-EACH,103,271,168,542,-.02152268,.30000001,.2985
212715,GRAPEFRUIT-EACH,99,197,176,472,0,.5,.56667495
212716,APPLES-COOKING-PER KG,29,129,210,368,0,1.95,2
212717,APPLES-DESSERT-PER KG,48,202,171,421,-.058380496,1.99,2.1800001
212718,PEARS-DESSERT-PER KG,60,186,204,450,0,1.99,2.1929801
212719,BANANAS-PER KG,19,111,384,514,0,.76999998,.76999998
212720,STRAWBERRIES PER KG OR PUNNET,337,69,34,440,.26582277,4.7199998,3.58005
212722,GRAPES-PER KG,179,155,195,529,0,4,4
212725,SMALL TYPE ORANGES PER PACK/KG,112,232,102,446,-.021526339,2.25,2.25
212726,PLUMS PER KG/PACK,178,115,180,473,0,2,1.895
212728,PINEAPPLE EACH,44,50,68,162,0,1,1.0455
212730,FRUIT FRESH SNACKING 150-350G,72,4,174,250,0,1.75,1.53125
212731,MELON EACH EG HONEYDEW,135,24,87,246,.11982078,.99000001,.65735996
212732,LEMON EACH,143,243,253,639,0,.33000001,.33557001
212733,BLUEBERRIES PUNNET OR PER KG,147,304,136,587,-.0039840392,11,11.67
212734,RASPBERRIES PUNNET OR PER KG,408,57,70,535,.14942677,10.6,9.1189995
212806,PACKET OF PEANUTS 150-300G,24,124,142,290,0,1.28,1.3
212807,CANNED FRUIT-400-450G,14,83,188,285,0,1,1
212808,DRIED FRUIT - EG APRICOTS,93,99,176,368,0,2,2
212905,VEGETABLE PICKLE 280-520G,101,116,74,291,0,1.5,1.5
212910,CANNED SOUP-390-425G,6,52,91,149,0,.94999999,.94999999
212917,TOMATO KETCHUP BOTTLE 340-570G,3,143,90,236,-.026290145,1.8,1.8522
212918,FRZN READY-COOKD MEAL SERVES 1,26,42,80,148,0,1.59,1.6
212923,COOK-IN SAUCE-JAR/CAN 350-520G,29,76,45,150,-.013806789,1.5,1.5
212928,FROZ VEG BURGER/GRILL 180-454G,45,101,121,267,0,1.75,1.9267499
212930,MAYONNAISE 390-500G/420-540MLS,71,34,135,240,0,1.5,1.5
212933,ICE CREAM 450ML-1L,54,17,77,148,0,1.99,1.75
212934,DRIED POTTED SNACK 50-120G,12,56,62,130,0,.75,.75
212936,CHILLED READY MEAL-MEAT-SERVS1,48,25,74,147,0,2.75,2.6950002
212937,CHILLED READY MEAL-FISH/VEG,38,31,73,142,0,2.7249999,2.6546249
212938,CHOCOLATE COVERED ICE CREAM,13,122,107,242,-.069767483,.62,.75
212939,CHILLED PIZZA EACH 300-600G,76,47,106,229,0,3,3.3109999
212940,PROTEIN POWDER 900G-2KG,78,110,79,267,0,22,20.921999
212941,QUICHE 340G-450G,81,49,106,236,0,2.0999999,2.2390499
212942,VEGETABLE CRISPS PACK 80-125G,60,82,90,232,0,1.5,1.74
213003,COFFEE-INSTANT-100G JAR,71,54,116,241,0,2.6500001,2.6500001
213005,HOT CHOCOLATE DRINK INSTANT,31,64,148,243,0,2.5,2.5
213006,COFFEE PODS PACK 8-16,45,50,78,173,0,3.5,3.99
213007,COFFEE SACHETS PACK,54,36,148,238,0,1.6900001,1.6900001
220107,PUB -HOT MEAL,104,208,22,334,-.0069513293,8.9249992,8.9804344
220116,LEMONADE/COLA DRAUGHT,35,253,26,314,-.0049751424,1.95,1.9779999
220117,BOTTLED MINERAL WATER,17,281,15,313,-.013806779,1.8,1.8252001
220120,IN STORE CAFETERIA MEAL,1,55,6,62,-.068033509,5.9499998,6.5450001
220121,RESTAURANT CUP OF COFFEE,21,292,25,338,-.031007729,2.5,2.615
220122,RESTAURANT - SWEET COURSE,20,340,23,383,-.043977037,5.75,5.9552999
220124,MUFFIN/INDIVIDUAL CAKE,13,211,10,234,-.036608826,2,2.036
220125,FRUIT JUICE BOTTLE 250-350ML,12,292,7,311,-.011857688,2.3499999,2.3781998
220128,RESTAURANT MAIN COURSE,19,356,16,391,-.036608856,12.5,13.52922
220208,STAFF RESTAURNT HOT SNACK ITEM,7,31,7,45,-.008919674,1,1.0089999
220209,PRIMARY SCHOOL- FIXED CHARGE,5,135,1,141,-.00099904882,2.3,2.3023
220210,SECONDARY SCHOOL- CAFETERIA,3,132,1,136,-.00099904998,2.4000001,2.4164
220214,STAFF RESTAURANT MAIN COURSE,3,31,7,41,-.035678916,1.7,1.7153
220301,FISH & CHIPS TAKEAWAY,15,55,61,131,0,6.9000001,6.9499998
220303,SANDWICH-TAKE-AWAY (COLD),82,99,161,342,0,2.5,2.5
220305,TEA -TAKE-AWAY,52,94,112,258,0,1.4449999,1.3986
220310,POTATO CRISPS-INDIVIDUAL PACK,3,292,13,308,-.018645782,1,1.0190001
220316,PIZZA TAKEAWAY OR DELIVERED,21,22,85,128,0,7.9949999,8.0187492
220318,INDIAN TAKEAWAY,26,33,74,133,0,7.8000002,7.9315996
220319,CHINESE TAKEAWAY,22,40,74,136,0,5.7249999,5.8000002
220320,TAKEAWAY SOFT DRINK,119,101,114,334,0,1.45,1.4463751
220321,TAKEAWAY COFFEE LATTE,21,148,76,245,-.016715787,2.5,2.6233997
220323,KEBAB- TAKEAWAY,19,34,77,130,0,5.5,5.5
220324,CINEMA POPCORN,0,73,2,75,-.027237339,5.3000002,5.4484
220325,VENDING MACHINE - SOFT DRINK,2,57,9,68,-.027237365,1.55,1.6448001
220326,TAKEAWAY CHICKEN & CHIPS,20,46,59,125,0,5.3000002,5.3559995
220327,T'AWAY COOKED SAVOURY PASTRY,30,93,122,245,0,1,1.035
220328,BURGER IN A BUN EAT IN OR TAKE,47,126,156,329,0,3.325,3.4001701
310102,DRAUGHT BITTER (PER PINT),28,261,12,301,-.01671581,3.2,3.2544
310104,DRAUGHT STOUT PER PINT,8,315,11,334,-.016715776,4,4.0230751
310109,LAGER - PINT 3.4-4.2%,8,321,12,341,-.01768175,3.55,3.6458497
310110,PREMIUM LAGER - PINT 4.3-7.5%,5,314,15,334,-.019607814,4.0999999,4.2361999
310111,BOTTLED PREMIUM LAGER 4.3-7.5%,10,310,14,334,-.02152637,3.7,3.7795501
310114,CIDER 4.5%-5.5% ABV PINT/BOTTL,35,288,15,338,-.017681733,3.8,3.8608
310207,BITTER-4CANS-440-500ML,9,32,89,130,0,3.75,3.75
310215,LAGER 4 BOTTLES- PREMIUM,33,98,91,222,-.011857657,4.5,4.7255998
310216,LAGER 10 - 24 CANS (440-500ML),70,14,68,152,.0834236,10,9.5
310217,LAGER 10-24 BOTTLES 250-330ML,22,10,40,72,0,10.75,10.340875
310219,STOUT - 4 CAN PACK,68,31,128,227,0,4.5,4.4899998
310220,SPEC'Y BEER BOTT 500ML 4-5.5,49,67,119,235,0,1.65,1.7
310221,APPLE CIDER 4 CAN PK 440-500ML,93,43,103,239,0,4,3.7839999
310222,CIDER FLAVOURED BOTT 500-568ML,79,39,119,237,0,2,2
310301,WHISKY (PER NIP) SPECIFY ML,29,298,12,339,-.0079365261,3.0999999,3.302
310302,VODKA (PER NIP) SPECIFY ML,11,322,11,344,-.017681727,3.4000001,3.5139999
310306,BOTTLE OF MIXER 125-200ML,19,307,10,336,-.027237341,1.5,1.5420001
310307,LIQUEUR PER NIP   SPECIFY ML,11,311,12,334,-.020568084,3.0999999,3.3659501
310309,SPIRIT BASED DRINK 275ML,5,203,6,214,-.016231932,3.2,3.2512
310310,"WINE, PER 175 - 250 ML SERVING",12,310,11,333,-.026290104,3.95,4.0326004
310315,BOTTLE OF WINE 70-75CL,2,329,25,356,-.027237331,19,19.871552
310316,GIN PER NIP,13,319,12,344,-.022482883,3.2,3.4271898
310401,WHISKY-70 CL BOTTLE,35,42,72,149,0,15,15
310403,VODKA-70 CL BOTTLE,46,60,137,243,0,14,13.77
310405,BRANDY 70CL BOTTLE,61,30,55,146,0,15,14.4725
310406,FORTIFIED WINE  (70-75CL),94,22,123,239,0,9,8.8829994
310419,WHITE WINE- EUROPEAN 75CL,68,104,69,241,0,6.25,6.5350895
310420,WHITE WINE- NEW WORLD 75CL,72,56,115,243,0,6.6900001,6.125
310421,RED WINE- EUROPEAN 75CL,66,66,111,243,0,6.75,6.3210001
310422,RED WINE- NEW WORLD 75CL,64,100,76,240,0,6.5,7
310423,BOTTLE OF CHAMPAGNE 75 CL,46,44,58,148,0,26.994999,26.884001
310425,ROSE WINE-75CL BOTTLE,59,40,48,147,0,6,6
310426,SPARKLING WINE 75CL MIN 11%ABV,52,67,124,243,0,7.4899998,7.2832499
310427,RUM WHITE EG BACARDI 70CL BOTT,68,59,110,237,0,14,12.488
310428,CREAM LIQUER 70CL-1LT 14-20%,42,80,107,229,0,15,16.085941
310429,GIN BOTTLE 70CL,51,80,111,242,0,15.5,15.5
310430,PRE MIXED SPIRIT 250-330ML,31,61,146,238,0,1.8,1.8
320108,CIGARETTES 8,18,64,63,145,0,13.34,13.34
320115,CIGARETTES 15,71,10,63,144,.0010009425,10.45,10.44
320122,20 FILTER - OTHER BRAND,20,61,63,144,0,12.33,12.39855
320124,E-CIG REFILL BOTTL/CART 2-10ML,23,38,174,235,0,3.95,3.95
320125,CIGARETTES 21,7,49,90,146,0,10.49,10.49
320205,5 CIGARS: SPECIFY BRAND,17,72,47,136,-.0059642461,6.6100001,6.6100001
320206,HAND ROLLING TOBACCO PACK 30GM,85,16,41,142,.017294047,15.75,15.74
410508,PLUMBER-DAYTIME HOURLY RATE,1,2,119,122,0,50,50.200001
410509,ELECTRICIAN-DAYTIME RATE/HOUR,0,1,143,144,0,41,41
410517,DECORATOR-DAILY RATE;SPEC HRS,0,7,98,105,0,150,150
410518,CARPENTER HOURLY RATE,0,5,90,95,0,25,25
410602,READY-MIXED FILLER-INT USE,17,67,76,160,0,5,5
410607,PAINT BRUSH-2INCH/5CM WIDTH,38,62,62,162,0,3.25,3.2764997
410611,DOOR HANDLE-PACK FOR ONE DOOR,23,38,95,156,0,12.99,12.99
410614,POWER DRILL-HAMMER ACTION,15,39,108,162,0,39.990002,40
410621,VARNISH-CLEAR GLOSS-750ML-1LTR,18,62,81,161,0,14.99,15.06723
410625,SCREWDRIVER,7,78,99,184,0,3.2,3.7992501
410629,WALLPAPER PER ROLL,14,39,78,131,0,9.25,10.064
410631,SHOWER HEAD,32,23,123,178,0,12,11.835
410632,HIRE OF DOMES CARPET CLEANER,10,50,51,111,0,24,24.024549
410633,MDF,3,125,10,138,-.28570518,24.93,35.393326
410637,CERAMI TILES 15X15-25X50CM BOX,25,48,67,140,0,10,11.051205
410638,WOODSCREWS STEEL/ZIN PLATED PK,3,72,80,155,-.019124955,1.95,2.0422502
410639,PAINT GLOSS/EMUL 750ML-2.5LTR,7,55,131,193,0,15.99,16
420101,COAL-HOUSEHOLD BEST QUAL 50KG,15,7,87,109,0,21.6,21.98
420103,SMOKELESS FUEL 50KG,5,15,89,109,0,25.25,25.25
420405,KEROSENE - 1000L DELIVERED,8,78,35,121,-.14602904,451.29001,478.8187
430101,DOUBLE WARDROBE,23,135,134,292,0,369.495,397.8475
430104,ARMCHAIR -UPHOLSTERED,36,126,79,241,-.033816386,469,470.10303
430108,DOUBLE BED-WIDTH APPROX 135CM,40,156,88,284,-.0049751517,494.495,499.98999
430119,KITCH BASE UNIT WIDTH 800-1000,13,75,34,122,-.046711192,122,122
430120,COFFEE TABLE,33,115,104,252,0,199.97,201.15923
430122,SINGLE BED-WIDTH 90CM/3FT,49,158,75,282,-.036608845,262,303.84717
430127,CHEST OF DRAWERS,43,143,98,284,-.043062143,250,270.5
430132,MATTRESS- 3FT/90CM,34,138,88,260,-.0714949,229,249
430133,BOOKCASE/FREESTAND SHELV UNIT,21,112,125,258,0,199,199
430134,TABLE LAMP,49,132,128,309,-.0079365112,16,18.31382
430136,PATIO TABLE & CHAIRS-SEASONAL,38,75,41,154,-.11971831,135,151.05251
430137,LEATHER SETTEE,19,97,49,165,-.074930586,1399,1429.99
430138,HOME OFFICE DESK,17,70,67,154,0,199,203.577
430139,KITCH WALL UNIT WIDTH 800-1000,32,55,47,134,0,81,77.769997
430140,SOFA BED,16,88,85,189,-.030067891,599,605.9848
430141,DINING TABLE & 2-6 CHAIRS,51,185,51,287,-.046711203,569.98999,649.46698
430142,HIGH CHAIR,58,65,45,168,0,44.995003,47.059544
430143,"SETTEE,NON LEATHER - SEE HELP",37,122,129,288,0,634,660.534
430211,DUVET-DOUBLE TOG 10-13.5,54,132,168,354,0,18,18.655998
430216,DUVET COVER,71,108,180,359,0,15,15.52964
430224,FITTED BED SHEET,51,116,195,362,0,8,8
430227,LAMINATE FLOORING PER SQ M,29,145,68,242,-.037536122,18.49,19.73061
430228,BATH SHEET,48,124,163,335,0,13.6,14.400001
430229,FABRIC ROLLER BLIND 120-180CM,27,22,117,166,0,14.99,14.99
430233,CARPET TUFTED 100% MANMADE FIB,24,170,39,233,-.079189651,20,21.059999
430234,CARPET TUFTED MIN 80% WOOL FIB,35,149,41,225,-.024390236,31.99,32.68446
430235,FLOOR RUG STATE SIZE & MATERIA,55,112,185,352,0,48.900002,47.8731
430236,CURTAINS READY MADE SP'FY SIZE,30,64,125,219,0,34.5,35
430237,LUXURY VINYL TILE PER SQ M,24,159,40,223,-.090909153,29.59,31.25
430304,ELECTRIC COOKER,42,96,35,173,-.022482878,399.98999,419.39999
430307,ELECTRIC KETTLE - 1.5-1.7L,58,81,124,263,0,29.99,30
430317,ELECTRIC IRON,56,70,131,257,0,29.99,29.99
430321,ELECTRIC RAZOR,57,48,53,158,0,49.990002,35.994003
430323,PHONE NT MOBILE(SPEC DIG/ANAL),20,93,93,206,0,34.990002,35.174477
430351,ELECTRIC HAIR STYLING APP,24,101,126,251,0,20,21.99
430355,VACUUM CLEANER,73,88,98,259,0,119,106.62666
430356,DISH WASHER 12-15 PLACE SET,33,119,74,226,-.031945806,328.20502,329
430359,ELECTRIC COOLING FAN -SEASONAL,16,189,45,250,-.095022604,20,24.360001
430361,WASHING MACH NO DRYER MAX 1800,79,165,22,266,-.044890217,384,416.10825
430362,FRIDGE/FREEZER SPEC CAPACITIES,43,170,48,261,-.068901293,379,418.75732
430363,ELECTRIC TOOTHBRUSH,109,107,190,406,0,30,34.990002
430407,"SMALL SAUCEPAN,MILK",19,89,59,167,-.043062184,5.9899998,5.5438895
430409,SCISSORS - HOUSEHOLD,23,78,74,175,-.049429659,2,2.4495001
430413,GAS FIRE,9,32,29,70,-.0044598314,561.79999,570.17004
430414,GAS COOKERS-SPECIFY MAKE & MOD,34,81,29,144,-.029126188,359,379.42401
430418,PLASTIC FOOD STORAGE CONTAINER,23,107,75,205,-.081726365,3,3.267
430419,STAINLESS STEEL CUTLERY SET,38,44,145,227,0,15,14.99
430422,PLAIN GLASS TUMBLER,23,106,105,234,-.0049751112,1,1
430423,FRYING PAN 24-30CM,35,104,82,221,-.061032943,14.4,14.4324
430424,"BAKEWARE, METAL, TRAY/ROASTING",42,125,161,328,0,8,7.2183151
430425,"DINNER PLATE, APPROX DIAMETER",44,101,161,306,0,3,3.125
430503,BALL POINT,11,119,147,277,0,.40000001,.5
430505,ALUMIN COOKING FOIL 290-300MM,16,47,84,147,0,1.8,1.8
430507,WASHING UP LIQUID 380-900ML,60,46,136,242,0,.80000001,.80000001
430509,HOUSEHOLD CLEANER CREAM/LIQUID,40,41,158,239,0,1,1
430518,REFUSE SACK FROM PACK OF 10-20,15,30,96,141,0,2.25,2.25
430524,LIGHT BULB,24,35,65,124,0,2.5,2.5
430525,CLEAR STICKY TAPE,14,100,158,272,0,1.5,1.60482
430526,GREETINGS CARD; STATE CODE,70,120,145,335,0,2,1.99
430527,A4 PRINTER PAPER (500 REAM),2,45,139,186,0,4.9899998,5.0224352
430529,BLEACH 750ML,55,6,86,147,0,.98000002,.96040004
430530,BLACK INKJET CARTRIDGE,26,119,124,269,0,18.99,18.99
430531,FABRIC CONDITIONER 500ML-1.5LT,50,41,51,142,0,1.95,1.6
430533,KITCHEN ROLL PK OF 2-4 SPECIFY,29,48,66,143,0,2,1.9823999
430535,SHEET OF WRAPPING PAPER,100,40,178,318,0,.56999999,.52893996
430536,TOILET ROLLS,57,25,76,158,0,1.895,1.89905
430538,DISHWASHER TABLETS PACK 16-45,65,30,129,224,0,5,4.428
430539,DRYCELL BATTERY 4 PACK EG AA,102,7,147,256,0,3.75,3.5138402
430540,WASHING LIQUID 800ML/1.5LTR,22,101,105,228,0,4.25,4.25
430541,LIGHT BULB SMART/WIFI,45,31,105,181,0,14.99,14.91505
430613,DOG FOOD-CAN-385-400GM,24,49,179,252,0,.64999998,.64999998
430617,ANIMAL CAGE (E.G FOR GERBIL),30,16,79,125,0,29.99,28.5
430621,ANNUAL BOOSTER INJECTION,8,73,72,153,0,44.400002,45.523499
430622,DOG KENNEL FEES DAILY CHARGE,4,40,89,133,0,16,16.450001
430623,SMALL CAGED MAMMAL,9,10,84,103,0,10,10
430624,CAT FOOD POUCH-IND-85G-100G,37,58,56,151,0,.34999999,.37
430625,WILD BIRD SEED PACK 500G-2KG,21,48,96,165,0,2.79,3
430626,"DOG TREATS,SPEC,TYPE 70-400G",39,57,176,272,0,1.29,1.29
440101,DOMESTIC CLEANER HOURLY RATE,0,34,111,145,0,13.5,13.5
440104,DRY CLEANING-MAN'S SUIT,4,78,162,244,0,13.35,13.5
440105,DRIVING LESSON 1 HOUR,1,196,0,197,-.017681759,28,29.521999
440113,WINDOW-CLEAN 3-BED SEMI,7,27,139,173,0,15,15
440116,WASHING MACHINE REPAIR,4,21,86,111,0,58,59.950001
440118,PC REPAIR,8,12,119,139,0,60,60
440120,CHILD MINDER - HOURLY RATE,3,21,105,129,0,4.5,4.5
440123,HOME REMOVAL- 1 VAN,5,25,78,108,0,476.39999,479.39999
440126,WEEKLY NANNY FEES,2,8,29,39,0,530,550
440127,MONTHLY SELF STORAGE FEE,20,49,44,113,0,99.620003,103.81
440128,HOME CARE ASSISTANT HRLY RATE,1,37,53,91,0,19,19.66
440129,PLAYGROUP FEES - PER SESSION,0,15,108,123,0,10.5,10.5
440131,WATCH BATTERY REPLACEMENT,1,181,11,193,-.055712923,9.9899998,10.57941
440132,MEN'S CLOTHING HIRE- SEE HELP,3,61,2,66,-.017681759,72.5,78.435547
440226,HOME-BUYERS SURVEY-RSDNTL PPTY,11,41,57,109,0,570,586.81
440227,FUNERAL-CREMATION,21,143,114,278,-.0044795736,2809,2837.9451
440232,NURSERY FEES: CHILD 0-4,3,59,91,153,0,43,43.5
440233,NEWSPAPER AD NON TRADE 20 WORD,10,26,84,120,0,20,20
440240,BASIC WILL FOR A SINGLE PERSON,0,15,53,68,0,231,240
440249,HOUSE CONVEYANCING,2,67,82,151,0,870,900
440254,HOURLY RATE FOR SOLICITOR,2,11,55,68,0,267,272.16
510101,MENS SUIT-READY MADE,56,134,103,293,-.022482935,95,101.36501
510104,MENS JACKET/COAT,127,121,69,317,0,39.990002,38.450001
510106,MENS JEANS,28,147,146,321,0,20,23.394001
510108,MEN'S JUMPER-KNITTED,107,108,98,313,0,17.99,17.99
510109,MEN'S FORMAL SHIRT-LONG SLEEVE,33,176,116,325,-.099909961,18,18
510113,MENS CASUAL S/SLEEVE TOP,60,144,117,321,0,15,16.99
510117,MEN'S FORMAL RDY-MADE TROUSERS,51,159,114,324,-.0099009536,22,24.878803
510118,MEN'S CASUAL TROUSERS,27,147,143,317,0,19.99,22
510120,MEN'S JUMPER OR SWEATSHIRT,69,143,109,321,0,19.5,22
510122,MEN'S TRACKSUIT/JOGGIN BOTTOMS,28,50,148,226,0,27,22.4
510124,MENS SHORTS NOT SWIMWEAR,91,170,54,315,-.12739968,16,21.784
510126,MENS BRANDED T-SHIRT,34,34,84,152,0,14,14
510127,MENS OFFICIAL FOOTBALL SHIRT,24,60,29,113,-.10793937,52,64.989998
510128,MEN'S BRANDED SPORT SWEATSHIRT,52,56,42,150,0,39.990002,35.075104
510131,MENS CASUAL SHIRT,62,135,126,323,0,17.99,18
510132,MEN'S T-SHIRT SHORT SLEEVED,41,102,173,316,0,6,6
510133,MENS LOUNGEWEAR BOTTOMS,43,128,145,316,0,16,17.994999
510206,WOMENS BLOUSE/SHIRT 1,107,133,90,330,0,15,15.757
510208,WOMEN'S FORMAL JACKET,74,158,94,326,-.062792942,25,34.999851
510212,WOMEN'S JUMPER,125,95,108,328,0,14,13.525644
510215,WOMENS BASIC PLAIN T-SHIRT,93,57,173,323,0,5.9899998,5.5
510219,WOMEN'S CASUAL OUTER JACKET,89,136,103,328,0,29,32
510223,WOMEN'S LONG SLV TOP-NT BLOUSE,80,130,119,329,0,12.99,14
510233,WOMEN'S CARDIGAN,95,143,93,331,0,14,16.633348
510235,WOMEN'S TROUSERS-CASUAL,110,143,76,329,0,16,16.335001
510236,WOMEN'S TROUSERS-FORMAL,89,128,111,328,0,16,19.99
510237,WOMEN'S SKIRT: CASUAL,108,160,63,331,0,16,19.8375
510238,WOMEN'S SKIRT: WORK/FORMAL,93,104,132,329,0,15,16.191
510244,WOMEN'S VEST/STRAPPY TOP,80,126,118,324,0,5.9899998,5.4795299
510245,WOMENS DRESS -CASUAL/FORMAL,116,139,75,330,0,19.5,22.824001
510246,WOMENS SHORT SLEEVE SPORTS TOP,54,86,88,228,0,14,12.5
510248,WOMEN'S JEANS- OWN BRAND,49,105,148,302,0,18,19.5
510249,WOMEN'S JEANS- BRANDED,23,36,38,97,0,79,79
510254,WOMENS SPORTSWEAR SHORTS,53,70,80,203,0,16.99,16.99
510255,WOMEN'S SWIMWEAR,32,69,121,222,0,14,15.68
510256,WOMEN'S SHOWERPROOF JACKET,33,54,70,157,0,65.970001,69.54261
510257,WOMENS BLOUSE / SHIRT 2,87,127,114,328,0,16,17.99
510258,WOMENS LEGGINGS FULL LENGTH,62,86,168,316,0,8.9899998,9.9949999
510259,WOMENS SHORT SLEEVE FORMAL TOP,96,183,49,328,-.14310203,14,17.598
510260,WOMENS EXERCISE LEGGINGS,70,95,87,252,0,22.99,22.99
510261,WOMEN'S SWEATSHIRT,73,156,117,346,0,15.495,16.864498
510324,TROUSERS  FOR SCHOOL 5-13 YRS,52,120,135,307,0,7,7.9899998
510328,BOYS JEANS (5-13 YEARS),60,97,133,290,0,10,10
510330,BABY SLEEPSUIT LONG SLEEVE,52,150,102,304,-.024390243,4,4.7592802
510336,GIRLS SKIRT FOR SCHOOL 5-13YRS,90,106,122,318,0,6,6.2339997
510340,GIRLS FASHION TOP 12-13 YEARS,73,62,67,202,0,8,9
510344,GIRLS TROUSERS NOT DENIM 5-13,85,115,120,320,0,8.9949999,8.0019999
510347,GIRLS JACKET (5-13 YEARS),150,59,111,320,.034196962,14,12.951401
510348,BOYS T-SHIRT 3-13 YEARS,60,72,96,228,0,9.7449999,10.02975
510349,GIRLS LEGGINGS 5-13 YEARS,45,151,136,332,0,4.9949999,4.4924998
510350,BOY'S JUMPER/SWTSHRT/CARDIGAN,96,173,79,348,-.0029910263,10.725,12.04875
510351,INFANT'S TROUSERS 0-2 YEARS,85,113,88,286,0,6,5.6400003
510352,INFANT'S JUMPR/SWTSHRT/CARDIGN,130,72,87,289,0,7,6.895
510402,MEN'S PANTS/BOXER SHORTS,43,127,147,317,0,4.3299999,4.5
510405,WOMEN'S NIGHTDRESS/PYJAMAS,105,117,101,323,0,12,10.950001
510406,WOMEN'S PANTS,73,79,168,320,0,3,3
510407,"BRA, CUP SIZE A-D RANGE",70,119,136,325,0,10,10
510410,CHILDS PYJAMAS 18MTHS-13YEARS,89,144,74,307,0,9.9899998,10
510411,CHILDS PANTS 1PR 18MTHS-13YRS,49,83,175,307,0,1.2,1.2
510413,MENS SOCKS 1 PAIR,39,121,157,317,0,2.4000001,2.4000001
510415,WOMEN'S TIGHTS,35,98,181,314,0,3,3.03
510416,CHILDS SOCKS 1 PR UK 3-6.5,43,130,141,314,0,.89999998,.90359998
510419,MEN'S TIE,53,118,138,309,0,7.5,7.5
510429,KNITTING WOOL-DOUBLE KNIT-100G,28,60,38,126,-.005964295,2,1.995
510432,LADY'S SCARF,64,94,150,308,0,8,6.7515001
510433,MENS BASE LAYER TOP LONG/SHORT,46,38,67,151,0,22.469999,20.405001
510434,"HAT/CAP, ADULT",111,69,153,333,0,8,8.335
510501,MENS SHOE FORMAL STYLE,32,175,106,313,-.059266161,49.990002,58
510506,WOMEN'S SANDALS,77,141,103,321,0,22.950001,26.99
510507,BOY'S SHOES,37,84,180,301,0,24,28
510508,GIRL'S SHOES SCHOOL,52,108,138,298,0,19,22.5
510515,MEN'S SHOE CASUAL STYLE,44,134,130,308,0,45,48
510516,MEN'S TRAINING SHOE-SPORTSWEAR,27,57,69,153,0,54.990002,49
510517,WOMEN'S TRAINING SHOES,22,50,81,153,0,47.990002,50.05357
510528,CHILD'S TRAINERS-SPORTS,46,56,49,151,0,30,31.348801
510529,WOMANS BOOTS,76,94,128,298,0,22,22.25
510530,HEEL,43,136,146,325,0,20,25
510533,WOMENS SHOE,78,128,99,305,0,24.99,25
510534,WALKING/HIKING BOOT,33,49,65,147,0,114.99,102.84
510535,CANVAS FASHION ADULT SHOE/TRAI,33,106,132,271,0,9.9899998,12.495
520103,LADY'S UMBRELLA -FOLDING,79,20,98,197,0,8,7
520109,LADIES HAND/SHLDER BAG,41,69,91,201,0,15.99,16.87401
520118,FLOWER VASE,19,64,122,205,0,6.9899998,7
520123,EARRINGS- FASHION,83,117,106,306,0,4,4.0240002
520130,SOLID GOLD RING 9CT,29,121,60,210,-.033331174,295,294.95898
520131,GENT'S WATCH- ANALOGUE FACE,77,97,87,261,0,175,179
520132,WALL HANGING MIRROR UPTO 1.5M,47,159,94,300,-.089253202,30,39.989998
520134,LUGGAGE TROLLEY CASE - 60-70CM,30,53,50,133,0,44.990002,45.44091
520135,DIAMOND SOLITAIRE RING,30,89,118,237,0,1000,1070
520136,PHOTO FRAME,36,67,129,232,0,7.1949997,8.4410591
520137,STERLING SILVER EARRINGS,83,50,106,239,0,19.99,17.29846
520138,SPECTACLE FRAMES WITH LENSE,13,12,119,144,0,77,79.5
520139,DAILY DISPOSABLE SOFT LENSES,9,11,122,142,0,28,28.134001
520140,NECKLACE FASHION APX 16/20 INS,69,108,152,329,0,7.5,7.6160002
520141,MOBILE PHONE ACCESSORY,36,161,174,371,0,12.99,12.99
520142,RE-USABLE BOTTLE/MUG ADULT,27,109,140,276,0,5.9899998,6.25
520202,INDIGESTION TABLETS 16-24 PACK,8,23,127,158,0,2.4000001,2.4288001
520206,TAMPONS-PACK OF 10-20,49,10,192,251,0,2,1.914
520209,TOOTHPASTE (SPECIFY SIZE),29,24,103,156,0,1.2,1
520213,TISSUES-LARGE SIZE BOX,57,13,86,156,0,1.5,1.13175
520215,MOISTURISER FACIAL 50-150ML,31,55,123,209,0,4.29,4.5
520216,DEODORANT/ANTI PERSPI 50-250ML,51,31,88,170,0,1.6,1.5
520219,"DISP NAPPIES, SPEC TYPE, 20-60",37,34,171,242,0,5,5
520222,MULTI-VITAMINS CAPSULES/TABLET,22,40,76,138,0,4.5,4.4842501
520223,MASCARA,36,31,135,202,0,8.4899998,8.4899998
520226,SHAMPOO-250-400ML,23,26,114,163,0,3,3
520227,PAIN KILLER TABLETS-16-24 PACK,32,36,89,157,0,1.7,1.7
520228,PLASTERS-20-40 PACK,39,29,90,158,0,1.99,1.99
520230,CONDOMS PACK OF 3-14,44,10,102,156,0,8,7.112
520234,PERFUME/EUD DE TOILETTE,38,57,97,192,0,20,20
520235,SUNSCREEN - SPEC SIZE/SPF,45,12,106,163,0,5.9899998,5.9899998
520236,WOMENS HAIR COLOURANT 60-140ML,16,10,98,124,0,6.4899998,6.4899998
520237,HAIR GEL 150-200ML,31,23,94,148,0,2.99,2.8554502
520238,SHOWER GEL 150-250ML,35,16,119,170,0,1,1
520241,RAZOR CARTRIDGE BLADES,20,75,53,148,-.018645782,10,10.1
520242,COLD/FLU DRINK POWDER,5,64,88,157,0,4.1500001,4.572
520243,LIQUID FOUNDATION 30-35ML,16,45,138,199,0,9.9799995,9.9799995
520244,TOOTHBRUSH,81,55,113,249,0,1.5,1.31937
520245,ANTIHISTAMINE ALLERGY TABLETS,62,27,136,225,0,3.5,3.0999999
520246,LIP GLOSS,51,33,160,244,0,6.9899998,6.9899998
520247,LIQUID SOAP 200-300ML,18,47,176,241,0,1,1
520248,CONDITIONER FOR HAIR,32,49,154,235,0,2,2
520249,BABY WIPES 50-85,23,132,98,253,-.044890217,.94999999,1
520250,NAIL VARNISH BOTTLE 6 - 14mls,30,19,169,218,0,3.5,3.4949999
520251,COUGH LIQUID BOTTLE 150-200MLS,15,115,122,252,0,4.75,5.2813249
520252,BODY M'RISING LOTION 200-400ML,71,37,160,268,0,4,3.5139
520253,SELF TANNING PRODUCT,44,120,179,343,0,7,8.5
520254,HAND HYGIENE GEL 50 -150ML,42,94,116,252,0,1.05,1.0428749
520301,MAN'S HAIRCUT,11,234,6,251,-.017681759,15,15.27
520303,WOMEN'S HRDRESSING-CUT/BLOWDRY,10,221,8,239,-.017681759,37,38.212502
520311,WOMENS HIGHLIGHTING,8,219,9,236,-.017681759,72,74.459999
520313,NON-NHS MEDICINE-PHYSIOTHERAPY,12,32,69,113,0,48,50
520324,RESIDENTIAL HOME,9,68,69,146,-.0099009899,800,826.61249
520325,NURSING HOME,5,55,68,128,0,952.5,972.63501
520326,PRIVATE DENTAL EXAMINATION,4,45,82,131,0,45,45
520331,BASIC MANICURE,9,100,5,114,-.017681697,20,20.32
520332,NON NHS CHIROPRACTOR,4,35,90,129,0,55,56.264999
610204,"CAR TYRE, STATE SIZE",38,110,52,200,-.02152637,69.800003,74.016441
610221,WINDSCREEN WIPER BLADES,4,49,95,148,0,8.4899998,9.7702398
610227,"CAR MOT TEST FEE, VAT EXEMPT",16,39,255,310,0,45,45
610231,CAR SERVICE- LOCAL GARAGE,3,24,72,99,0,169,172.8
610232,CAR SERVICE- MAIN DEALER,10,25,51,86,0,227,232.39799
610235,CAR REPAIRS MAIN DEALER,6,14,67,87,0,118.8,120
610236,CAR REPAIRS LOCAL GARAGE,5,9,89,103,0,60,60
610237,CAR BULB 12 VOLT SPECIFY WATTS,17,28,105,150,0,3.5,3.5
610238,CAR WASH HAND OR AUTOMATIC,12,26,56,94,0,5,5
610239,EXHAUST FITTING FAST FIT CENT,14,47,21,82,-.0049751,374.09998,408.08102
610241,WHEEL ALIGNMENT,7,10,77,94,0,49.974998,49.974998
610303,OIL PER LITRE-MULTIGRADE,31,45,46,122,0,10.745,11.0125
620303,SELF-DRIVE VAN HIRE,26,74,142,242,0,60,61.730003
620304,PUSHCHAIR/STROLLER,15,51,42,108,-.0049751243,149.99001,167.31052
620307,SELF-DRIVE CAR HIRE BASIC 24HR,53,100,59,212,0,62.525002,61.046402
620308,MINICAB FARE FOR 2 MILES,3,32,96,131,0,6,6.0500002
620315,CAR PARK CHARGES,8,54,198,260,0,2.2,2.3027999
620317,CHILDS BICYCLE,19,160,70,249,-.071494877,110,115.28
620318,ADULT BIKE,15,156,76,247,-.086757988,279.98999,312.03702
620319,CYCLE HELMET 12+ SPEC ROAD/MOU,53,63,174,290,0,30,30
630138,DIGITAL RADIO (DAB),30,81,81,192,0,69,70.673508
630156,HEADPHONES SPECIFY TYPE,103,127,137,367,0,20,21.02948
630159,OR SMALLER,29,219,50,298,-.041227225,209,210.53476
630160,OR LARGER,45,198,37,280,-.090909131,429,478.677
630162,PORTABLE SPEAKER,91,157,125,373,0,42.990002,46.214252
630164,DVD/BLU RAY PLAYER,105,76,89,270,0,59.990002,59.990002
630165,PORTABLE DIGITAL MUSIC PLAYER,36,36,75,147,0,199,199
630226,RECORDABLE CD PRICE PER CD,21,86,116,223,0,.40000001,.40000001
630228,PRE-RECORDED DVD (FILM),5,20,17,42,-.040441222,10,10
630229,PRE-RECORDED DVD (NON-FILM),7,16,11,34,-.0049751434,5,5.0574999
630230,CD ALBUM (TOP 40),1,27,5,33,-.2006395,10,12.08
630231,CD ALBUM (NOT CHART),6,13,15,34,-.046711132,5,5
630233,BLU RAY DISC (FILM) FROM CHART,3,24,12,39,-.055712949,15,15.885
630309,BOXED BOARD GAME: NOT TRAVEL,37,54,78,169,0,19.99,20
630312,CHILD'S PLASTIC DOLL,67,20,108,195,0,10,10
630313,MODEL RD VEHICLE EG HOT WHEELS,66,31,96,193,0,1.85,1.87374
630314,CONSTRUCTION TOY: SPEC KIT NO,62,18,94,174,0,12.995,11.702145
630317,"SLEEPING BAG, ADULT",15,51,80,146,0,30,31.093124
630332,CHILD'S SOFT TOY/TEDDY BEAR,55,47,96,198,0,10,10
630336,FOOTBALL,7,77,57,141,-.00099903846,16,16.784
630340,CARBON FIBRE FISHING ROD,6,22,55,83,0,39.990002,39.990002
630341,PRESCHOOL ACTIVITY TOY,57,39,77,173,0,10,9
630342,BEGINNER'S ACOUSTIC GUITAR,14,29,40,83,0,99.989998,99.989998
630343,MEN'S FOOTBALL BOOTS,22,42,54,118,0,60,66.010002
630345,GOLF BALLS PRICE PER BALL,3,44,85,132,0,1,1
630347,CHILD'S BABY DOLL,33,49,89,171,0,15,15
630357,SQUASH/TENNIS RACQUET,11,37,87,135,0,20,20.02
630358,PORTABLE DIGITAL STORAGE DEVIC,51,95,94,240,0,9.9899998,11.62473
630359,DIGITAL DEVELOPMENT PER PRINT,5,70,50,125,-.0079365298,.55000001,.55440003
630365,CRAFT KIT FOR CHILD 5 YRS+,103,18,97,218,.0020040222,8.4799995,7.0729947
630368,ELECTRONIC EDUCATIONAL TOY,24,76,101,201,0,18,18
630369,CHARCOAL BBQ NOT DISPOSABLE,29,93,76,198,-.11660775,25,28.450001
630373,JIGSAW MINIMUM 100 PIECES,97,25,88,210,.05596621,10,8.4317646
630374,CHILDS SCOOTER AGE 5-12 YEARS,74,54,87,215,0,30,26.67333
630376,CHILDS SIT & RIDE TOY U'ER 5'S,103,26,69,198,.048218086,32.990002,30
630377,ACTION CAMERA,62,24,25,111,.17508812,34,35.988003
630378,COMPUTER GAME 1,22,2,5,29,.025640985,39,38.025002
630379,COMPUTER GAME 2,25,3,1,29,.38696247,20.99,17.350109
630380,COMPUTER GAME 3,26,3,0,29,.66666669,21.99,16.31658
630381,HAND WEIGHTS FOR HOME EXERCISE,64,79,58,201,0,13.99,13.89573
630422,BOOK-REFERENCE (EG ATLAS/DICT),36,69,75,180,0,10,10.9789
630425,BOOK-NON-FICTION-HARD-COVER,36,165,15,216,-.16597165,12.99,16.164001
630426,BOOK-NON-FICTION-PAPER-BACK,50,112,15,177,-.089253239,8.9899998,9.4601603
630434,BOOK ILLUSTRATED FOR UNDER 5,21,80,85,186,0,5.9899998,6.1936598
630435,BOOK - FICTION - HARD COVER,40,148,8,196,-.23547401,14,18.288
630437,BOOK - TEENAGE FICTION,32,93,59,184,-.06279286,7.9899998,7.9899998
630439,BOOK FICTION P/BACK TOP 10,34,128,66,228,-.11111113,7.2399998,7.2831249
630440,"CHILDS BOOK, FICTION 6-12YRS",17,117,82,216,-.069767483,6.77,6.6548896
630505,GARDEN SPADE,14,61,75,150,0,14.95,14.171
630507,HOUSEPLANT,97,49,53,199,.028806623,4.5,4.3739996
630510,POTTING COMPOST,5,66,71,142,-.021525502,5.4000001,5.9899998
630518,CUT FLOWERS-CARNATIONS-STEM,51,47,71,169,0,.40000001,.39320001
630519,POTTED SHRUB,13,57,58,128,-.010880314,3.3699999,3.1593752
630520,"MOWER ELECTRIC, SPECIFY TYPE",13,61,77,151,-.034749005,74.989998,79.989998
630525,PLANT FOOD 800ML-2LT/500G-1.5K,51,48,52,151,0,4,4.0259099
630526,"SEEDS,PKT,SPEC VAR(SEASONAL)",26,48,86,160,0,1.8,1.85
640212,THEATRE ADULT EVES-FRONT STLLS,5,18,9,32,-.027237359,18,19.184999
640219,SWIMMING POOL ADM STND ADULT,0,123,0,123,-.0059642564,4.9000001,4.9294004
640222,EXERCISE CLASS UPTO 1HR,1,114,6,121,-.031007664,6.5,6.7188001
640224,TEN-PIN BOWLING PER GAME,9,108,0,117,-.027237352,7,7.1960001
640226,PRIVATE HEALTH CLUB ANNUAL FEE,7,89,2,98,-.017681755,379.5,393.69501
640240,LIVERY CHARGES PER WEEK,0,16,84,100,0,96.540001,98.282059
640243,SOFT PLAY SESSION TIME PERIOD,0,91,0,91,-.027237345,6.0999999,6.2708001
640406,HOTEL 1 NIGHT PRICE,7,49,14,70,-.12587416,70,85.800003
