item_id,item_desc,p_up,p_down,p_level,region,p_ch,p,p_r
210102,LARGE LOAF-WHITE-UNSLICED-800G,84,6,24,114,1.1004785,1.1,1.011
210106,SIX BREAD ROLLS-WHITE/BROWN,28,96,23,147,.74976569,.80000001,1
210111,WHITE SLICED LOAF BRANDED 750G,84,60,5,149,1.0496184,1.1,1
210113,WHOLEMEAL SLICED LOAF BRANDED,79,59,10,148,1.1,.99000001,1
210114,CHILLED GARLIC BREAD,50,141,51,242,.89999998,.89999998,1
210201,FLOUR-SELF-RAISING-1.5KG,10,122,14,146,.76187432,.60000002,.92850006
210204,DRY SPAGHETTI OR PASTA 500G,57,145,40,242,.5859375,.60000002,1
210211,CORN SNACK SINGLE PACK MAX 50G,2,116,9,127,.84985834,.85000002,1
210212,BASMATI RICE 500G-1KG,131,0,17,148,1.6,1.6,1
210213,BREAKFAST CEREAL 1,198,14,30,242,2.5,2.8,1
210214,BREAKFAST CEREAL 2,209,24,9,242,1.9,1.9,1
210215,CEREAL BAR,0,230,8,238,.33000001,.25,1
210216,HOT OAT CEREAL,180,33,12,225,1.75,1.99,1
210217,RICE MICRO POUCH/TRAY 220-280G,56,123,61,240,.99000001,.99000001,1
210218,"POPCORN, BAG, 10-30G",1,175,37,213,.30000001,.30000001,1
210219,BREAKFAST CEREAL GLUTEN FREE,164,20,30,214,2.0891509,1.95,1
210221,COUSCOUS PLAIN/FLAVOURED,11,153,10,174,.69999999,.69999999,1
210301,CREAM CRACKERS PACK 200G-300G,67,59,23,149,1,1,1
210302,PLAIN BISCUITS-200-300G,58,66,26,150,1,1,1.034
210319,DOUGHNUT-EACH,2,117,15,134,.261233,.22499999,1
210320,WHOLE SPONGE CAKE NOT FROZEN,105,5,37,147,1.8494425,1.6900001,1
210321,PACK OF 5-6 INDIVIDUAL CAKES,88,18,37,143,1.4,1.6,1
210323,BISCUITS HALF CHOC 260-400G,135,86,23,244,1.3495277,1.35,1
210324,CRUMPETS PACK 6-9 SPEC NUMBER,28,185,13,226,.89999998,.89999998,1
210403,HOME KILLED BEEF-LEAN MINCE KG,257,0,12,269,6.5999999,6.4899998,1
210406,HOME KLD BEEF-RUMP/POPES STEAK,250,0,16,266,15.77,15.505,1
210414,FROZEN BEEFBURGERS PACK OF 4,137,0,6,143,2.3896351,2.49,1
210416,BEEF ROASTING JOINT PER KG,202,0,44,246,11.5,11,1
210506,HK LAMB LOIN CHOP/STEAK PER KG,321,0,37,358,13.34275,13.86,1
210507,HOME KILLED LAMB SHOULDER KG,193,0,53,246,8.9899998,8.7749996,1
210703,HOME KILLED PORK-LOIN CHOPS KG,191,0,49,240,6.6700001,6.4749999,1
210802,BACON-GAMMON-PER KG,233,0,28,261,7.4000001,7,1
210808,BACON-BACK-PER KG,267,0,8,275,7.0028014,7.3000002,1
210905,FRESH/CHILLED CHICKEN  PER KG,230,0,21,251,2.747736,2.79,1
210910,FRESH BONELESS CHICKEN BREAST,257,0,10,267,6.6666665,6.3499999,1
210913,ROTISSERIE CHICKEN [WHOLE],36,0,8,44,4.9900203,5,1.002
210914,FRESH TURKEY DICED/MIN PER KG,60,0,12,72,6.5985131,6.8000002,1.0009999
211007,CANNED MEAT-STEWED STEAK,126,0,16,142,2.5,2.45,1
211011,INDIVIDUAL MEAT PIE,162,62,39,263,1.4910536,1.35,1
211014,SAUSAGES-PORK-PER KG,269,0,7,276,5.7399998,5.5,1
211019,FROZ CHICKEN NUGGETS 220-600G,123,5,17,145,1.650165,1.5,1
211023,COOKED HAM PREPACKED SLICED,158,10,7,175,2.0506253,2,1
211024,CONTINENTAL SLICED DELI MEAT,152,3,13,168,2,2.0999999,1
211025,JOINT OV/READ GAM/POR 450-900G,148,0,11,159,5,5,1
211026,CHICKEN KIEV 2 PACK 240-325G,206,0,26,232,2.0672283,2,1
211027,H K LIVER PER KG STATE TYPE,133,0,13,146,2.5,2.5,1.0039999
211029,COOKED MEAT TURKEY/CHICK SLICE,304,4,40,348,1.9793322,1.75,1
211030,MEAT BASED SNACK PACK MAX 400G,207,13,21,241,1.75,1.75,1
211031,COOKED HAM LOOSE PER 100G,123,8,7,138,1.641138,1.55,1
211101,FRESH WHITE FISH FILLETS KG,131,0,16,147,16.419386,15,1
211105,FRESH FISH-SALMON FILLETS-KG,136,0,10,146,16.819717,14.805,.972
211106,FROZEN PRAWNS PER KG,164,0,9,173,16.76358,15.28,1
211207,"CANNED FISH, TUNA, 130G-200G",42,71,23,136,.91907459,.89999998,1
211210,FROZEN FISH FINGERS 8-12 PK,221,13,9,243,2.0906048,2.5,1
211211,FROZEN BREAD/BAT FISH 400-550G,235,0,7,242,3.5999999,3.5999999,1
211305,SPREADABLE BUTTER,235,0,6,241,3.25,3.25,1
211306,BUTTER 250G SPEC COO,227,0,15,242,1.7003188,1.7,1
211407,MARGARINE/LOW FAT SPREAD-500G,97,33,18,148,1.3003901,1.75,1.2509999
211408,OLIVE OIL - 500ML - 1 LITRE,232,0,8,240,3.4000001,3.4000001,1
211409,"PEANUT BUTTER, JAR, 225-350G",232,12,8,252,1.75,2.0699999,1
211501,CHEDDAR-HOME PRODUCED PER KG,141,0,7,148,6.2516556,5.6700001,.99900001
211506,"CHEESE SPREAD, 125g-200g TUB",70,15,42,127,1.25,1,1
211509,HARD REGIONAL CHEESE PER KG,141,0,4,145,7.1471467,7.0500002,1
211510,PARMESAN CHEESE-PER KG,136,0,6,142,17.65,17.65,1
211511,SOFT CONTINENTAL CHEESE - KG,227,0,8,235,8.9651642,7.5,1
211602,EGGS-MEDIUM-PER DOZ OR 2 X 6,132,0,5,137,1.8527904,1.78,1
211603,EGGS-LARGE-PER DOZ OR 2 X 6,140,0,5,145,2.2,2.2,1.005
211709,SHOP MILK-WHOLE MILK-4PT/2LTR,239,3,2,244,1.1386138,1.09,1
211710,MILK SEMI-PER 2 PINTS/1.136 L,4,141,2,147,.81967211,.80000001,1
211713,"MILK FLAVOURED, 180-500MLS/GMS",126,29,70,225,1.15,1.15,1
211714,NON-DAIRY MILK DRINK 900ML-1LT,167,51,26,244,1.4,1.5,1.0455
211807,"YOGHURT/FROMAGE 4-6PK, 45-125G",71,19,56,146,1.0078877,1.3,1.0485001
211808,CHILLED POT DESSERT 125-200G,20,120,19,159,.68000001,.68000001,1
211814,YOGHURT-SMALL INDIVIDUAL,0,136,10,146,.63694274,.60000002,1
211815,FRESH DOUBLE CREAM 250ML-300ML,113,30,4,147,1.15,1.1,1
211816,POWDERED BABY FORMULA 400-900G,215,0,11,226,10.748107,10.75,1.0239999
211901,TEA BAGS PKT OF 80 (230G-250G),123,17,8,148,2,2,1
211904,TEA BAGS-2-PACKET OF 240,169,0,2,171,3.4995625,3.5,1
211905,"FLAVRD TEA 15-20 BAGS, 30-40G",217,10,9,236,1.7782428,1.7,1
212001,"FRUIT SQUASH, 750ML - 1.5LT",186,28,28,242,1.5006002,1.25,1
212006,FRUIT JUICE NOT ORANGE 1L,36,91,19,146,.90042377,.89999998,1
212008,LEMONADE-2 LITRE BOTTLE,37,88,21,146,.64999998,.5,.99100006
212010,MINERAL WATER STILL 1.5-2L,7,129,86,222,.64999998,.5,.85750002
212015,FIZZY ENERGY DRINK 250-500ML,134,14,12,160,1.4494228,1.45,1
212016,FRESH/CHILL ORANGE JUICE 900ML,124,23,2,149,2.48,1.75,.94300002
212017,FIZZY BOTTLED DRINK 500ML,141,2,7,150,1.500484,1.45,1
212020,FRUIT DRINK BOTTLE 4-8 PACK,134,28,61,223,1.4478765,2,1.053
212021,BOTTLE STILL WATER 500ML,1,184,61,246,.49847409,.35500002,.99699998
212022,MIXER DRINK BOTTLE 1L EG TONIC,112,111,20,243,1.1499536,.60000002,1
212023,COLA/FIZZY DRINK 330ML PK 4-8,216,2,8,226,3,3,1
212024,FLAVOURED WATER BOTT 900ML-1.5,34,194,14,242,.55016184,.60000002,1
212025,"COLA DRINK, REG,BOTTLE,1.25-2L",222,1,13,236,2,1.9,1
212026,"COLA DRINK, DIET 1.25-2LTR",179,41,21,241,1.640245,1.5,1
212027,FRUIT/VEG SMOOTHIE,156,0,18,174,2.9985008,2,1
212101,SUGAR -GRANULATED-WHITE-PER KG,38,196,7,241,.74000001,.69999999,1
212106,JAR OF JAM-340-454G,45,63,35,143,1,.85000002,1
212107,HONEY JAR/BOTTLE 340G-454G,213,6,21,240,2.5,2.0999999,1
212202,MINTS,5,120,10,135,.66000003,.64999998,1
212211,CHOCOLATE 4,4,126,10,140,.69999999,.69999999,1
212214,FRUIT PASTILLES 2,2,107,17,126,.6591357,.64999998,1
212217,CHEWING/BUBBLE GUM-SINGLE PK,0,140,4,144,.56999999,.60000002,1
212218,CARTON/BOX OF CHOCS 150-400GM,109,0,13,122,4.79,4.4949999,1
212222,CHOCOLATE 10,5,105,9,119,.72087252,.69999999,1
212223,BRAND CHOC SWEETS 90-185G BAG,128,20,73,221,1.1252813,1,1
212224,"SWEETS, NOT CHOC, 150-250G BAG",138,38,45,221,1.0928961,1,.949
212225,CHOCOLATE LARGE BAR 100-200G,160,29,23,212,1.6129031,1.45,1
212226,CHOCOLATE 12,0,191,12,203,.59820539,.60000002,1
212228,MALTED CHOCOLATE SWEETS,7,141,14,162,.66006607,.60000002,.917
212309,POTATOES-NEW-PER KG,331,149,47,527,1.33,1.3200001,1
212310,POTATOES- OLD WHITE PER KG,56,441,40,537,.59999996,.47999999,1
212311,POTATOES- BAKING PR KG,126,298,51,475,.77934265,.80000001,1
212402,POTATO CRISPS 25G-50G,0,238,12,250,.83826429,.85000002,1.0204999
212404,POTATO CRISPS-MULTI-PACK,277,95,16,388,1.4450867,1.5,1
212405,FROZEN CHIPS 900G-1.5KG,324,30,37,391,1.79,1.8,1
212408,PREMIUM POTATO CRISPS/CHIPS,156,2,4,162,1.9893899,1.3200001,.99199998
212409,P'PARED MASHED POTATO 400-650G,177,72,110,359,1.0384216,1,1
212504,FRESH VEG-CAULIFLOWER-EACH,151,288,120,559,.94966763,.89999998,1
212510,FRESH VEG-CUCUMBER-WHOLE,44,498,22,564,.57983941,.55000001,1
212511,FRESH VEG-LETTUCE-ICEBERG-EACH,71,439,28,538,.58984911,.43000001,.991
212515,FRESH VEG-TOMATOES-PER KG,495,0,22,517,2.2995782,2.1800001,.98799998
212516,FRESH VEG-CABBAGE-WHOLE-PER KG,77,424,30,531,.75,.75,1
212518,FRESH VEG-CARROTS-PER KG,95,433,20,548,.5,.5,1
212519,FRESH VEG-ONIONS-PER KG,129,378,36,543,.85000002,.85000002,1.008
212520,FRESH VEG-MUSHROOMS-PER KG,536,1,14,551,3.1700001,3.1700001,1
212527,PRE-PACKED SALAD 100-250G,81,19,48,148,1.25,1,1
212530,FRESH VEG-BROCCOLI-PER KG,453,18,65,536,1.9405756,1.75,1
212531,FRESH VEG-COURGETTE-PER KG,461,2,79,542,2.1800001,2.1500001,1
212532,FRESH VEG-PEPPERS -LOOSE OR KG,138,392,16,546,.5,.47999999,1
212533,VEGETABLE STIR FRY FRESH PACK,124,0,128,252,1.2,1.2,1
212535,SWEET POTATO PER KG OR EACH,386,158,83,627,1.1247444,1.1,.99699998
212601,CANNED TOMATOES 390-400G,18,360,13,391,.4055115,.44999999,1.125
212603,"BAKED BEANS, 400-420G TIN",1,376,11,388,.84973162,.85000002,1
212608,CANNED SWEETCORN 198-340G,1,258,19,278,.74976569,.75,1.033
212609,FROZEN GARDEN PEAS 800G-1KG,102,91,97,290,1,1,1
212612,FROZEN PRE-PREPARED VEGTABLES,113,125,143,381,1,1,1
212709,ORANGES-CLASS 1-EACH,3,505,27,535,.36344755,.38999999,1
212710,AVOCADO PEAR-EACH,99,385,59,543,.84967321,.85000002,1.0549999
212712,KIWI FRUIT-EACH,0,502,40,542,.28874347,.30000001,1.0015
212715,GRAPEFRUIT-EACH,2,423,47,472,.50100201,.5,1
212716,APPLES-COOKING-PER KG,260,0,108,368,1.9890447,1.95,1
212717,APPLES-DESSERT-PER KG,322,12,87,421,1.9590775,1.99,1
212718,PEARS-DESSERT-PER KG,363,10,77,450,2.0899999,1.99,1
212719,BANANAS-PER KG,139,290,85,514,.79000002,.76999998,1
212720,STRAWBERRIES PER KG OR PUNNET,408,6,26,440,6.242197,4.7199998,.76499999
212722,GRAPES-PER KG,505,2,22,529,4,4,1
212725,SMALL TYPE ORANGES PER PACK/KG,401,21,24,446,2.25,2.25,1.012
212726,PLUMS PER KG/PACK,399,2,72,473,2.5946107,2,.977
212728,PINEAPPLE EACH,55,76,31,162,1,1,1
212730,FRUIT FRESH SNACKING 150-350G,169,8,73,250,2,1.75,1
212731,MELON EACH EG HONEYDEW,215,11,20,246,1.7992424,.99000001,.66399997
212732,LEMON EACH,0,624,15,639,.32098484,.33000001,1
212733,BLUEBERRIES PUNNET OR PER KG,553,7,27,587,11.077124,11,1.003
212734,RASPBERRIES PUNNET OR PER KG,490,6,39,535,13.243195,10.6,.85799998
212806,PACKET OF PEANUTS 150-300G,188,59,43,290,1.25,1.28,1
212807,CANNED FRUIT-400-450G,50,104,131,285,1,1,1
212808,DRIED FRUIT - EG APRICOTS,304,29,35,368,2,2,1
212905,VEGETABLE PICKLE 280-520G,211,44,36,291,1.5,1.5,1
212910,CANNED SOUP-390-425G,35,89,25,149,.94999999,.94999999,1
212917,TOMATO KETCHUP BOTTLE 340-570G,167,58,11,236,1.749271,1.8,1.0239999
212918,FRZN READY-COOKD MEAL SERVES 1,94,15,39,148,1.6922445,1.59,1
212923,COOK-IN SAUCE-JAR/CAN 350-520G,93,49,8,150,1.45,1.5,1.0105
212928,FROZ VEG BURGER/GRILL 180-454G,228,2,37,267,1.75,1.75,1
212930,MAYONNAISE 390-500G/420-540MLS,165,63,12,240,1.5,1.5,1
212933,ICE CREAM 450ML-1L,142,0,6,148,2.3166473,1.99,1
212934,DRIED POTTED SNACK 50-120G,21,94,15,130,.75,.75,1
212936,CHILLED READY MEAL-MEAT-SERVS1,141,1,5,147,2.75,2.75,1
212937,CHILLED READY MEAL-FISH/VEG,131,0,11,142,2.7491407,2.7249999,1
212938,CHOCOLATE COVERED ICE CREAM,15,205,22,242,.5,.62,1.015
212939,CHILLED PIZZA EACH 300-600G,209,0,20,229,3.301887,3,1
212940,PROTEIN POWDER 900G-2KG,257,0,10,267,21.998238,22,1
212941,QUICHE 340G-450G,227,0,9,236,2.3,2.0999999,1
212942,VEGETABLE CRISPS PACK 80-125G,178,5,49,232,1.6592921,1.5,1
213003,COFFEE-INSTANT-100G JAR,221,0,20,241,2.6500001,2.6500001,1
213005,HOT CHOCOLATE DRINK INSTANT,205,27,11,243,2.5,2.5,1
213006,COFFEE PODS PACK 8-16,161,0,12,173,3.99,3.5,1
213007,COFFEE SACHETS PACK,199,28,11,238,1.6900001,1.6900001,1
220107,PUB -HOT MEAL,312,0,22,334,8.905941,8.9249992,1.007
220116,LEMONADE/COLA DRAUGHT,299,7,8,314,1.9773431,1.95,1.005
220117,BOTTLED MINERAL WATER,295,3,15,313,1.870086,1.8,1.0140001
220120,IN STORE CAFETERIA MEAL,56,0,6,62,6.1043806,5.9499998,1.073
220121,RESTAURANT CUP OF COFFEE,310,3,25,338,2.4454148,2.5,1.0319999
220122,RESTAURANT - SWEET COURSE,360,0,23,383,5.6026363,5.75,1.045
220124,MUFFIN/INDIVIDUAL CAKE,207,17,10,234,1.9267823,2,1.038
220125,FRUIT JUICE BOTTLE 250-350ML,304,0,7,311,2.3573856,2.3499999,1.012
220128,RESTAURANT MAIN COURSE,375,0,16,391,12.12406,12.5,1.036
220208,STAFF RESTAURNT HOT SNACK ITEM,22,16,7,45,1.5857286,1,1.0089999
220209,PRIMARY SCHOOL- FIXED CHARGE,139,1,1,141,2.2977021,2.3,1.001
220210,SECONDARY SCHOOL- CAFETERIA,135,0,1,136,2.3976023,2.4000001,1.001
220214,STAFF RESTAURANT MAIN COURSE,32,2,7,41,1.7096136,1.7,1.0089999
220301,FISH & CHIPS TAKEAWAY,128,0,3,131,6.9254656,6.9000001,1
220303,SANDWICH-TAKE-AWAY (COLD),298,2,42,342,2.6500001,2.5,1
220305,TEA -TAKE-AWAY,183,47,28,258,1.494024,1.4449999,1
220310,POTATO CRISPS-INDIVIDUAL PACK,111,184,13,308,.98135424,1,1.0190001
220316,PIZZA TAKEAWAY OR DELIVERED,124,0,4,128,8.4500389,7.9949999,1
220318,INDIAN TAKEAWAY,129,0,4,133,7.9484897,7.8000002,1
220319,CHINESE TAKEAWAY,130,0,6,136,5.7992392,5.7249999,1
220320,TAKEAWAY SOFT DRINK,260,47,27,334,1.4705883,1.45,1
220321,TAKEAWAY COFFEE LATTE,238,0,7,245,2.4059999,2.5,1.015
220323,KEBAB- TAKEAWAY,128,0,2,130,5.5,5.5,1
220324,CINEMA POPCORN,72,1,2,75,5.155642,5.3000002,1.028
220325,VENDING MACHINE - SOFT DRINK,54,5,9,68,1.6536118,1.55,1.028
220326,TAKEAWAY CHICKEN & CHIPS,120,0,5,125,5.2165809,5.3000002,1
220327,T'AWAY COOKED SAVOURY PASTRY,119,56,70,245,1.0040323,1,1
220328,BURGER IN A BUN EAT IN OR TAKE,290,20,19,329,3.3,3.325,1
310102,DRAUGHT BITTER (PER PINT),289,0,12,301,3.1925344,3.2,1.017
310104,DRAUGHT STOUT PER PINT,323,0,11,334,3.9331369,4,1.017
310109,LAGER - PINT 3.4-4.2%,329,0,12,341,3.5265224,3.55,1.018
310110,PREMIUM LAGER - PINT 4.3-7.5%,319,0,15,334,4.0686278,4.0999999,1.02
310111,BOTTLED PREMIUM LAGER 4.3-7.5%,320,0,14,334,3.6567535,3.7,1.021
310114,CIDER 4.5%-5.5% ABV PINT/BOTTL,323,0,15,338,3.8288288,3.8,1.018
310207,BITTER-4CANS-440-500ML,95,0,35,130,4.1252484,3.75,1
310215,LAGER 4 BOTTLES- PREMIUM,191,0,31,222,4.7518477,4.5,1
310216,LAGER 10 - 24 CANS (440-500ML),123,0,29,152,11.001101,10,.921
310217,LAGER 10-24 BOTTLES 250-330ML,59,0,13,72,12.044653,10.75,1
310219,STOUT - 4 CAN PACK,202,0,25,227,4.7483382,4.5,1
310220,SPEC'Y BEER BOTT 500ML 4-5.5,217,0,18,235,1.7,1.65,1
310221,APPLE CIDER 4 CAN PK 440-500ML,234,0,5,239,4.1501975,4,1
310222,CIDER FLAVOURED BOTT 500-568ML,225,0,12,237,2.1992238,2,1
310301,WHISKY (PER NIP) SPECIFY ML,327,0,12,339,3.092293,3.0999999,1.008
310302,VODKA (PER NIP) SPECIFY ML,332,1,11,344,3.1894011,3.4000001,1.018
310306,BOTTLE OF MIXER 125-200ML,227,98,11,336,1.4591858,1.5,1.028
310307,LIQUEUR PER NIP   SPECIFY ML,311,11,12,334,3.1142092,3.0999999,1.021
310309,SPIRIT BASED DRINK 275ML,208,0,6,214,3.1527095,3.2,1.016
310310,"WINE, PER 175 - 250 ML SERVING",322,0,11,333,3.889971,3.95,1.027
310315,BOTTLE OF WINE 70-75CL,331,0,25,356,18.953934,19,1.028
310316,GIN PER NIP,332,0,12,344,3.1311157,3.2,1.023
310401,WHISKY-70 CL BOTTLE,141,0,8,149,15,15,1
310403,VODKA-70 CL BOTTLE,233,0,10,243,14.001807,14,1
310405,BRANDY 70CL BOTTLE,132,0,14,146,18.140106,15,.99349999
310406,FORTIFIED WINE  (70-75CL),223,0,16,239,10.600707,9,1
310419,WHITE WINE- EUROPEAN 75CL,226,0,15,241,6.4991331,6.25,1
310420,WHITE WINE- NEW WORLD 75CL,222,0,21,243,6.8800459,6.6900001,1
310421,RED WINE- EUROPEAN 75CL,236,0,7,243,6.75,6.75,1
310422,RED WINE- NEW WORLD 75CL,223,0,17,240,6.6860466,6.5,1
310423,BOTTLE OF CHAMPAGNE 75 CL,127,0,21,148,35,26.994999,1
310425,ROSE WINE-75CL BOTTLE,140,0,7,147,6.3002329,6,1
310426,SPARKLING WINE 75CL MIN 11%ABV,233,0,10,243,6.9979005,7.4899998,1
310427,RUM WHITE EG BACARDI 70CL BOTT,213,0,24,237,14.994233,14,1
310428,CREAM LIQUER 70CL-1LT 14-20%,215,0,14,229,15,15,1
310429,GIN BOTTLE 70CL,239,0,3,242,14.503818,15.5,1
310430,PRE MIXED SPIRIT 250-330ML,198,9,31,238,1.8,1.8,1
320108,CIGARETTES 8,143,0,2,145,13.34,13.34,1
320115,CIGARETTES 15,140,0,4,144,10.491968,10.45,.99900001
320122,20 FILTER - OTHER BRAND,138,0,6,144,12.33,12.33,1
320124,E-CIG REFILL BOTTL/CART 2-10ML,190,2,43,235,3.99,3.95,1
320125,CIGARETTES 21,139,0,7,146,10.454986,10.49,1
320205,5 CIGARS: SPECIFY BRAND,133,0,3,136,6.6100001,6.6100001,1.0039999
320206,HAND ROLLING TOBACCO PACK 30GM,140,0,2,142,15.75,15.75,.98199999
410508,PLUMBER-DAYTIME HOURLY RATE,121,0,1,122,50,50,1
410509,ELECTRICIAN-DAYTIME RATE/HOUR,143,0,1,144,42,41,1
410517,DECORATOR-DAILY RATE;SPEC HRS,105,0,0,105,149.95314,150,1
410518,CARPENTER HOURLY RATE,95,0,0,95,23,25,1
410602,READY-MIXED FILLER-INT USE,156,0,4,160,5.4899998,5,1
410607,PAINT BRUSH-2INCH/5CM WIDTH,145,0,17,162,3.5899999,3.25,1
410611,DOOR HANDLE-PACK FOR ONE DOOR,149,0,7,156,13,12.99,1
410614,POWER DRILL-HAMMER ACTION,137,0,25,162,40,39.990002,1
410621,VARNISH-CLEAR GLOSS-750ML-1LTR,155,0,6,161,13.996265,14.99,1
410625,SCREWDRIVER,160,2,22,184,3.2245183,3.2,1
410629,WALLPAPER PER ROLL,121,0,10,131,9.9899998,9.25,1
410631,SHOWER HEAD,162,0,16,178,12.136364,12,1
410632,HIRE OF DOMES CARPET CLEANER,105,0,6,111,23.000959,24,1
410633,MDF,134,0,4,138,20.12377,24.93,1.3805001
410637,CERAMI TILES 15X15-25X50CM BOX,134,0,6,140,10.999084,10,1
410638,WOODSCREWS STEEL/ZIN PLATED PK,137,4,14,155,2.4135923,1.95,1
410639,PAINT GLOSS/EMUL 750ML-2.5LTR,186,0,7,193,15.864641,15.99,1
420101,COAL-HOUSEHOLD BEST QUAL 50KG,109,0,0,109,21.809099,21.6,1
420103,SMOKELESS FUEL 50KG,106,0,3,109,25.174999,25.25,1
420405,KEROSENE - 1000L DELIVERED,86,0,35,121,425.34402,451.29001,1.061
430101,DOUBLE WARDROBE,271,0,21,292,399.99271,369.495,1
430104,ARMCHAIR -UPHOLSTERED,223,0,18,241,494.86301,469,1.029
430108,DOUBLE BED-WIDTH APPROX 135CM,267,0,17,284,479.83682,494.495,1.005
430119,KITCH BASE UNIT WIDTH 800-1000,120,0,2,122,119.04762,122,1.049
430120,COFFEE TABLE,237,0,15,252,202.45399,199.97,1
430122,SINGLE BED-WIDTH 90CM/3FT,261,0,21,282,255.21822,262,1.026
430127,CHEST OF DRAWERS,262,0,22,284,263.88022,250,1.0185
430132,MATTRESS- 3FT/90CM,239,0,21,260,224.93225,229,1.0550001
430133,BOOKCASE/FREESTAND SHELV UNIT,245,0,13,258,199,199,1
430134,TABLE LAMP,263,0,46,309,24.991072,16,1
430136,PATIO TABLE & CHAIRS-SEASONAL,118,0,36,154,198.9818,135,1
430137,LEATHER SETTEE,149,0,16,165,1395,1399,1.054
430138,HOME OFFICE DESK,143,0,11,154,194.52591,199,1
430139,KITCH WALL UNIT WIDTH 800-1000,129,0,5,134,102.99626,81,1
430140,SOFA BED,165,0,24,189,549.0376,599,1
430141,DINING TABLE & 2-6 CHAIRS,273,0,14,287,599.82697,569.98999,1.039
430142,HIGH CHAIR,160,0,8,168,54.486832,44.995003,1
430143,"SETTEE,NON LEATHER - SEE HELP",262,0,26,288,649.59106,634,1
430211,DUVET-DOUBLE TOG 10-13.5,300,0,54,354,18.001801,18,1
430216,DUVET COVER,334,0,25,359,17.6,15,1
430224,FITTED BED SHEET,351,0,11,362,8,8,1
430227,LAMINATE FLOORING PER SQ M,224,0,18,242,18.208467,18.49,1.039
430228,BATH SHEET,320,0,15,335,12.99,13.6,1
430229,FABRIC ROLLER BLIND 120-180CM,163,0,3,166,14.99,14.99,1
430233,CARPET TUFTED 100% MANMADE FIB,219,0,14,233,18.993353,20,1.086
430234,CARPET TUFTED MIN 80% WOOL FIB,209,0,16,225,31.548321,31.99,1.025
430235,FLOOR RUG STATE SIZE & MATERIA,322,0,30,352,50,48.900002,1
430236,CURTAINS READY MADE SP'FY SIZE,212,0,7,219,33.170616,34.5,1
430237,LUXURY VINYL TILE PER SQ M,198,0,25,223,24.997286,29.59,1.1
430304,ELECTRIC COOKER,163,0,10,173,360,399.98999,1.017
430307,ELECTRIC KETTLE - 1.5-1.7L,248,0,15,263,30,29.99,1
430317,ELECTRIC IRON,221,0,36,257,34.981586,29.99,1
430321,ELECTRIC RAZOR,131,0,27,158,55.002895,49.990002,.98199999
430323,PHONE NT MOBILE(SPEC DIG/ANAL),189,0,17,206,34.99527,34.990002,1
430351,ELECTRIC HAIR STYLING APP,215,0,36,251,20,20,1
430355,VACUUM CLEANER,237,0,22,259,139.06865,119,1
430356,DISH WASHER 12-15 PLACE SET,187,0,39,226,329,328.20502,1.0265
430359,ELECTRIC COOLING FAN -SEASONAL,242,0,8,250,18.245773,20,1.098
430361,WASHING MACH NO DRYER MAX 1800,255,0,11,266,349.91846,384,1.0470001
430362,FRIDGE/FREEZER SPEC CAPACITIES,238,0,23,261,350.08078,379,1.0470001
430363,ELECTRIC TOOTHBRUSH,370,0,36,406,40,30,1
430407,"SMALL SAUCEPAN,MILK",143,0,24,167,5.9899998,5.9899998,1.0089999
430409,SCISSORS - HOUSEHOLD,111,7,57,175,2.5,2,1
430413,GAS FIRE,64,0,6,70,572.09814,561.79999,1
430414,GAS COOKERS-SPECIFY MAKE & MOD,131,0,13,144,370,359,1.027
430418,PLASTIC FOOD STORAGE CONTAINER,164,5,36,205,3,3,1.063
430419,STAINLESS STEEL CUTLERY SET,213,0,14,227,15,15,1
430422,PLAIN GLASS TUMBLER,100,84,50,234,1,1,1
430423,FRYING PAN 24-30CM,191,0,30,221,14.629459,14.4,1
430424,"BAKEWARE, METAL, TRAY/ROASTING",308,1,19,328,7.47012,8,1
430425,"DINNER PLATE, APPROX DIAMETER",278,5,23,306,3,3,1
430503,BALL POINT,13,251,13,277,.4549908,.40000001,1
430505,ALUMIN COOKING FOIL 290-300MM,142,2,3,147,1.8243701,1.8,1
430507,WASHING UP LIQUID 380-900ML,78,129,35,242,.89581931,.80000001,1
430509,HOUSEHOLD CLEANER CREAM/LIQUID,72,74,93,239,1,1,1
430518,REFUSE SACK FROM PACK OF 10-20,134,1,6,141,2.25,2.25,1
430524,LIGHT BULB,104,0,20,124,2.5,2.5,1
430525,CLEAR STICKY TAPE,209,44,19,272,1.5,1.5,1
430526,GREETINGS CARD; STATE CODE,268,40,27,335,1.99,2,1
430527,A4 PRINTER PAPER (500 REAM),182,0,4,186,4.9750743,4.9899998,1
430529,BLEACH 750ML,37,73,37,147,.99244589,.98000002,1
430530,BLACK INKJET CARTRIDGE,249,0,20,269,18.99,18.99,1
430531,FABRIC CONDITIONER 500ML-1.5LT,124,5,13,142,2,1.95,1
430533,KITCHEN ROLL PK OF 2-4 SPECIFY,127,2,14,143,2,2,1
430535,SHEET OF WRAPPING PAPER,71,174,73,318,.74962521,.56999999,1
430536,TOILET ROLLS,148,0,10,158,2,1.895,1
430538,DISHWASHER TABLETS PACK 16-45,216,0,8,224,5,5,1
430539,DRYCELL BATTERY 4 PACK EG AA,232,0,24,256,4,3.75,1
430540,WASHING LIQUID 800ML/1.5LTR,218,0,10,228,4.0015244,4.25,1
430541,LIGHT BULB SMART/WIFI,177,0,4,181,14.99,14.99,1
430613,DOG FOOD-CAN-385-400GM,16,225,11,252,.64999998,.64999998,1
430617,ANIMAL CAGE (E.G FOR GERBIL),117,0,8,125,30,29.99,1
430621,ANNUAL BOOSTER INJECTION,147,0,6,153,43.499512,44.400002,1
430622,DOG KENNEL FEES DAILY CHARGE,130,0,3,133,16,16,1
430623,SMALL CAGED MAMMAL,90,0,13,103,10,10,1
430624,CAT FOOD POUCH-IND-85G-100G,2,132,17,151,.44025156,.34999999,1
430625,WILD BIRD SEED PACK 500G-2KG,125,4,36,165,3,2.79,1
430626,"DOG TREATS,SPEC,TYPE 70-400G",163,47,62,272,1.3,1.29,1
440101,DOMESTIC CLEANER HOURLY RATE,140,0,5,145,13.09824,13.5,1
440104,DRY CLEANING-MAN'S SUIT,235,0,9,244,13,13.35,1
440105,DRIVING LESSON 1 HOUR,197,0,0,197,27.504911,28,1.018
440113,WINDOW-CLEAN 3-BED SEMI,173,0,0,173,15,15,1
440116,WASHING MACHINE REPAIR,106,0,5,111,58.900002,58,1
440118,PC REPAIR,135,0,4,139,60,60,1
440120,CHILD MINDER - HOURLY RATE,126,0,3,129,4.5,4.5,1
440123,HOME REMOVAL- 1 VAN,108,0,0,108,473,476.39999,1
440126,WEEKLY NANNY FEES,35,0,4,39,550,530,1
440127,MONTHLY SELF STORAGE FEE,113,0,0,113,91.002045,99.620003,1
440128,HOME CARE ASSISTANT HRLY RATE,79,0,12,91,18.924303,19,1
440129,PLAYGROUP FEES - PER SESSION,111,0,12,123,11.25,10.5,1
440131,WATCH BATTERY REPLACEMENT,182,0,11,193,9.4428701,9.9899998,1.059
440132,MEN'S CLOTHING HIRE- SEE HELP,64,0,2,66,75.541718,72.5,1.018
440226,HOME-BUYERS SURVEY-RSDNTL PPTY,100,0,9,109,569.93561,570,1
440227,FUNERAL-CREMATION,276,0,2,278,2790.6978,2809,1.0039999
440232,NURSERY FEES: CHILD 0-4,149,0,4,153,42.769379,43,1
440233,NEWSPAPER AD NON TRADE 20 WORD,109,0,11,120,20,20,1
440240,BASIC WILL FOR A SINGLE PERSON,61,0,7,68,240,231,1
440249,HOUSE CONVEYANCING,142,0,9,151,870,870,1
440254,HOURLY RATE FOR SOLICITOR,64,0,4,68,270,267,1
510101,MENS SUIT-READY MADE,243,0,50,293,113.10085,95,1
510104,MENS JACKET/COAT,303,0,14,317,39.929016,39.990002,1
510106,MENS JEANS,317,0,4,321,22.5,20,1
510108,MEN'S JUMPER-KNITTED,262,0,51,313,26.004728,17.99,.986
510109,MEN'S FORMAL SHIRT-LONG SLEEVE,321,0,4,325,17.99,18,1.108
510113,MENS CASUAL S/SLEEVE TOP,320,0,1,321,15,15,1
510117,MEN'S FORMAL RDY-MADE TROUSERS,313,0,11,324,22,22,1
510118,MEN'S CASUAL TROUSERS,312,0,5,317,19.99,19.99,1
510120,MEN'S JUMPER OR SWEATSHIRT,306,0,15,321,19.500389,19.5,1
510122,MEN'S TRACKSUIT/JOGGIN BOTTOMS,222,0,4,226,27.984547,27,1
510124,MENS SHORTS NOT SWIMWEAR,307,0,8,315,15.503876,16,1.125
510126,MENS BRANDED T-SHIRT,150,0,2,152,14,14,1
510127,MENS OFFICIAL FOOTBALL SHIRT,104,0,9,113,52,52,1.029
510128,MEN'S BRANDED SPORT SWEATSHIRT,145,0,5,150,37.977211,39.990002,1
510131,MENS CASUAL SHIRT,319,0,4,323,17.99,17.99,1
510132,MEN'S T-SHIRT SHORT SLEEVED,313,0,3,316,6,6,1
510133,MENS LOUNGEWEAR BOTTOMS,303,0,13,316,16,16,1
510206,WOMENS BLOUSE/SHIRT 1,324,0,6,330,14.995832,15,1
510208,WOMEN'S FORMAL JACKET,290,0,36,326,25,25,1
510212,WOMEN'S JUMPER,303,0,25,328,15,14,1
510215,WOMENS BASIC PLAIN T-SHIRT,320,0,3,323,6,5.9899998,1
510219,WOMEN'S CASUAL OUTER JACKET,318,0,10,328,32,29,1
510223,WOMEN'S LONG SLV TOP-NT BLOUSE,319,0,10,329,12.5,12.99,1
510233,WOMEN'S CARDIGAN,320,0,11,331,15.005359,14,1
510235,WOMEN'S TROUSERS-CASUAL,327,0,2,329,15.991471,16,1
510236,WOMEN'S TROUSERS-FORMAL,321,0,7,328,16.414141,16,1
510237,WOMEN'S SKIRT: CASUAL,321,0,10,331,14.99,16,1
510238,WOMEN'S SKIRT: WORK/FORMAL,310,0,19,329,15.498331,15,1
510244,WOMEN'S VEST/STRAPPY TOP,320,0,4,324,5.5,5.9899998,1
510245,WOMENS DRESS -CASUAL/FORMAL,327,0,3,330,22,19.5,1
510246,WOMENS SHORT SLEEVE SPORTS TOP,219,0,9,228,14.995586,14,1
510248,WOMEN'S JEANS- OWN BRAND,299,0,3,302,16.26898,18,1
510249,WOMEN'S JEANS- BRANDED,94,0,3,97,79,79,1
510254,WOMENS SPORTSWEAR SHORTS,191,0,12,203,17.997751,16.99,1
510255,WOMEN'S SWIMWEAR,212,0,10,222,12.5,14,1
510256,WOMEN'S SHOWERPROOF JACKET,152,0,5,157,77.462219,65.970001,1
510257,WOMENS BLOUSE / SHIRT 2,324,0,4,328,16,16,1
510258,WOMENS LEGGINGS FULL LENGTH,307,0,9,316,9.5,8.9899998,1
510259,WOMENS SHORT SLEEVE FORMAL TOP,325,0,3,328,12.004802,14,1.1670001
510260,WOMENS EXERCISE LEGGINGS,248,0,4,252,22.99,22.99,1
510261,WOMEN'S SWEATSHIRT,341,0,5,346,14.997,15.495,1
510324,TROUSERS  FOR SCHOOL 5-13 YRS,288,0,19,307,7.9915338,7,1
510328,BOYS JEANS (5-13 YEARS),280,0,10,290,10,10,1
510330,BABY SLEEPSUIT LONG SLEEVE,292,0,12,304,4.6705899,4,1
510336,GIRLS SKIRT FOR SCHOOL 5-13YRS,287,0,31,318,6.7437382,6,1
510340,GIRLS FASHION TOP 12-13 YEARS,199,0,3,202,8.4877129,8,1
510344,GIRLS TROUSERS NOT DENIM 5-13,291,0,29,320,8.9988756,8.9949999,1
510347,GIRLS JACKET (5-13 YEARS),296,0,24,320,18,14,.92500001
510348,BOYS T-SHIRT 3-13 YEARS,225,0,3,228,8.996212,9.7449999,1
510349,GIRLS LEGGINGS 5-13 YEARS,324,0,8,332,4.9949999,4.9949999,1
510350,BOY'S JUMPER/SWTSHRT/CARDIGAN,341,0,7,348,10,10.725,1
510351,INFANT'S TROUSERS 0-2 YEARS,275,0,11,286,5.9895053,6,1
510352,INFANT'S JUMPR/SWTSHRT/CARDIGN,275,0,14,289,7.9866662,7,1
510402,MEN'S PANTS/BOXER SHORTS,311,0,6,317,4.6693382,4.3299999,1
510405,WOMEN'S NIGHTDRESS/PYJAMAS,308,0,15,323,12.000801,12,1
510406,WOMEN'S PANTS,275,12,33,320,3.99,3,1
510407,"BRA, CUP SIZE A-D RANGE",316,0,9,325,8.9909496,10,1
510410,CHILDS PYJAMAS 18MTHS-13YEARS,293,0,14,307,9.0027704,9.9899998,1
510411,CHILDS PANTS 1PR 18MTHS-13YRS,183,107,17,307,1.2,1.2,1
510413,MENS SOCKS 1 PAIR,258,47,12,317,2.4000001,2.4000001,1
510415,WOMEN'S TIGHTS,264,32,18,314,3,3,1
510416,CHILDS SOCKS 1 PR UK 3-6.5,113,174,27,314,.89999998,.89999998,1
510419,MEN'S TIE,285,1,23,309,9.9899998,7.5,1
510429,KNITTING WOOL-DOUBLE KNIT-100G,106,1,19,126,2,2,1
510432,LADY'S SCARF,258,0,50,308,9.985714,8,1
510433,MENS BASE LAYER TOP LONG/SHORT,127,0,24,151,30,22.469999,1
510434,"HAT/CAP, ADULT",316,0,17,333,10,8,1
510501,MENS SHOE FORMAL STYLE,299,0,14,313,39.505188,49.990002,1.0470001
510506,WOMEN'S SANDALS,309,0,12,321,26.99,22.950001,1
510507,BOY'S SHOES,282,0,19,301,28,24,1
510508,GIRL'S SHOES SCHOOL,266,0,32,298,19.99,19,1
510515,MEN'S SHOE CASUAL STYLE,292,0,16,308,48,45,1
510516,MEN'S TRAINING SHOE-SPORTSWEAR,150,0,3,153,48,54.990002,1
510517,WOMEN'S TRAINING SHOES,148,0,5,153,47.990002,47.990002,1
510528,CHILD'S TRAINERS-SPORTS,146,0,5,151,28.505604,30,1
510529,WOMANS BOOTS,221,0,77,298,36.231884,22,.954
510530,HEEL,313,0,12,325,27.500996,20,1
510533,WOMENS SHOE,270,0,35,305,27.500996,24.99,1
510534,WALKING/HIKING BOOT,141,0,6,147,114.99,114.99,1
510535,CANVAS FASHION ADULT SHOE/TRAI,254,0,17,271,11.238846,9.9899998,1
520103,LADY'S UMBRELLA -FOLDING,178,0,19,197,10.358074,8,1
520109,LADIES HAND/SHLDER BAG,178,0,23,201,19.988333,15.99,1
520118,FLOWER VASE,186,0,19,205,7.5,6.9899998,1
520123,EARRINGS- FASHION,265,2,39,306,5,4,1
520130,SOLID GOLD RING 9CT,194,0,16,210,278.97681,295,1.015
520131,GENT'S WATCH- ANALOGUE FACE,245,0,16,261,199,175,1
520132,WALL HANGING MIRROR UPTO 1.5M,264,0,36,300,31.876137,30,1.0935
520134,LUGGAGE TROLLEY CASE - 60-70CM,109,0,24,133,46.029919,44.990002,1
520135,DIAMOND SOLITAIRE RING,216,0,21,237,1150,1000,1
520136,PHOTO FRAME,200,1,31,232,11.962027,7.1949997,1
520137,STERLING SILVER EARRINGS,215,0,24,239,20.512819,19.99,1
520138,SPECTACLE FRAMES WITH LENSE,138,0,6,144,82.474998,77,1
520139,DAILY DISPOSABLE SOFT LENSES,137,0,5,142,28,28,1
520140,NECKLACE FASHION APX 16/20 INS,283,0,46,329,8.9896193,7.5,1
520141,MOBILE PHONE ACCESSORY,346,1,24,371,14.638671,12.99,1
520142,RE-USABLE BOTTLE/MUG ADULT,255,1,20,276,5.9941072,5.9899998,1
520202,INDIGESTION TABLETS 16-24 PACK,145,0,13,158,2.49,2.4000001,1
520206,TAMPONS-PACK OF 10-20,236,12,3,251,2,2,1
520209,TOOTHPASTE (SPECIFY SIZE),83,33,40,156,1.2,1.2,1
520213,TISSUES-LARGE SIZE BOX,98,25,33,156,1.5,1.5,1
520215,MOISTURISER FACIAL 50-150ML,197,0,12,209,4.5,4.29,1
520216,DEODORANT/ANTI PERSPI 50-250ML,131,8,31,170,1.9004524,1.6,1
520219,"DISP NAPPIES, SPEC TYPE, 20-60",219,0,23,242,5.2657976,5,1
520222,MULTI-VITAMINS CAPSULES/TABLET,118,1,19,138,5,4.5,1
520223,MASCARA,191,0,11,202,8.4899998,8.4899998,1
520226,SHAMPOO-250-400ML,147,2,14,163,2.9992504,3,1
520227,PAIN KILLER TABLETS-16-24 PACK,115,27,15,157,1.7497813,1.7,1
520228,PLASTERS-20-40 PACK,129,1,28,158,1.99,1.99,1
520230,CONDOMS PACK OF 3-14,149,0,7,156,8.9988756,8,1
520234,PERFUME/EUD DE TOILETTE,156,0,36,192,34.664429,20,1
520235,SUNSCREEN - SPEC SIZE/SPF,142,0,21,163,6.5,5.9899998,1
520236,WOMENS HAIR COLOURANT 60-140ML,121,0,3,124,6.4899998,6.4899998,1
520237,HAIR GEL 150-200ML,128,1,19,148,3.1506848,2.99,1
520238,SHOWER GEL 150-250ML,84,47,39,170,1.0952563,1,1
520241,RAZOR CARTRIDGE BLADES,133,0,15,148,10.294406,10,1.008
520242,COLD/FLU DRINK POWDER,148,0,9,157,4,4.1500001,1
520243,LIQUID FOUNDATION 30-35ML,190,0,9,199,9.9205561,9.9799995,1
520244,TOOTHBRUSH,193,21,35,249,1.5991471,1.5,1
520245,ANTIHISTAMINE ALLERGY TABLETS,211,2,12,225,4.4977512,3.5,1
520246,LIP GLOSS,234,1,9,244,6.9899998,6.9899998,1
520247,LIQUID SOAP 200-300ML,79,80,82,241,1,1,1
520248,CONDITIONER FOR HAIR,177,31,27,235,2,2,1
520249,BABY WIPES 50-85,75,124,54,253,.99000001,.94999999,1.024
520250,NAIL VARNISH BOTTLE 6 - 14mls,194,0,24,218,3.5,3.5,1
520251,COUGH LIQUID BOTTLE 150-200MLS,242,0,10,252,4.5,4.75,1
520252,BODY M'RISING LOTION 200-400ML,253,0,15,268,4.3000002,4,1
520253,SELF TANNING PRODUCT,318,1,24,343,7.0028014,7,1
520254,HAND HYGIENE GEL 50 -150ML,127,46,79,252,1.0365251,1.05,1
520301,MAN'S HAIRCUT,245,0,6,251,14.691479,15,1.018
520303,WOMEN'S HRDRESSING-CUT/BLOWDRY,231,0,8,239,36.328873,37,1.018
520311,WOMENS HIGHLIGHTING,227,0,9,236,71.568626,72,1.018
520313,NON-NHS MEDICINE-PHYSIOTHERAPY,111,0,2,113,48,48,1
520324,RESIDENTIAL HOME,127,0,19,146,812,800,1
520325,NURSING HOME,117,0,11,128,968.44,952.5,1
520326,PRIVATE DENTAL EXAMINATION,130,0,1,131,44.861248,45,1
520331,BASIC MANICURE,109,0,5,114,19.68504,20,1.018
520332,NON NHS CHIROPRACTOR,128,0,1,129,54.988152,55,1
610204,"CAR TYRE, STATE SIZE",187,0,13,200,67.970001,69.800003,1.0135
610221,WINDSCREEN WIPER BLADES,145,0,3,148,8.4899998,8.4899998,1
610227,"CAR MOT TEST FEE, VAT EXEMPT",302,0,8,310,45,45,1
610231,CAR SERVICE- LOCAL GARAGE,97,0,2,99,168,169,1
610232,CAR SERVICE- MAIN DEALER,81,0,5,86,232.99889,227,1
610235,CAR REPAIRS MAIN DEALER,82,0,5,87,119.40594,118.8,1
610236,CAR REPAIRS LOCAL GARAGE,99,0,4,103,60,60,1
610237,CAR BULB 12 VOLT SPECIFY WATTS,131,5,14,150,3.5,3.5,1
610238,CAR WASH HAND OR AUTOMATIC,92,0,2,94,5,5,1
610239,EXHAUST FITTING FAST FIT CENT,80,0,2,82,389.35913,374.09998,1.0039999
610241,WHEEL ALIGNMENT,92,0,2,94,49.950001,49.974998,1
610303,OIL PER LITRE-MULTIGRADE,107,0,15,122,11.235409,10.745,1
620303,SELF-DRIVE VAN HIRE,236,0,6,242,60.012344,60,1
620304,PUSHCHAIR/STROLLER,101,0,7,108,151.9337,149.99001,1
620307,SELF-DRIVE CAR HIRE BASIC 24HR,204,0,8,212,53.388596,62.525002,1
620308,MINICAB FARE FOR 2 MILES,131,0,0,131,6,6,1
620315,CAR PARK CHARGES,230,8,22,260,2.2501101,2.2,1
620317,CHILDS BICYCLE,213,0,36,249,118.73351,110,1.059
620318,ADULT BIKE,211,0,36,247,327.85971,279.98999,1.071
620319,CYCLE HELMET 12+ SPEC ROAD/MOU,278,0,12,290,30,30,1
630138,DIGITAL RADIO (DAB),172,0,20,192,79.010376,69,1
630156,HEADPHONES SPECIFY TYPE,341,0,26,367,22.988504,20,1
630159,OR SMALLER,275,0,23,298,198.01155,209,1.043
630160,OR LARGER,251,0,29,280,379.88403,429,1.0779999
630162,PORTABLE SPEAKER,344,0,29,373,48.457188,42.990002,1
630164,DVD/BLU RAY PLAYER,241,0,29,270,79,59.990002,1
630165,PORTABLE DIGITAL MUSIC PLAYER,147,0,0,147,199,199,1
630226,RECORDABLE CD PRICE PER CD,1,171,51,223,.38493177,.40000001,1
630228,PRE-RECORDED DVD (FILM),40,0,2,42,9.1911764,10,1
630229,PRE-RECORDED DVD (NON-FILM),29,0,5,34,7.0028014,5,1
630230,CD ALBUM (TOP 40),30,0,3,33,7.9936047,10,1.251
630231,CD ALBUM (NOT CHART),24,0,10,34,4.7675805,5,1
630233,BLU RAY DISC (FILM) FROM CHART,38,0,1,39,14.164306,15,1.059
630309,BOXED BOARD GAME: NOT TRAVEL,157,0,12,169,20,19.99,1
630312,CHILD'S PLASTIC DOLL,177,0,18,195,11.995386,10,1
630313,MODEL RD VEHICLE EG HOT WHEELS,171,5,17,193,2.9898672,1.85,1
630314,CONSTRUCTION TOY: SPEC KIT NO,155,0,19,174,17.982004,12.995,1
630317,"SLEEPING BAG, ADULT",136,0,10,146,30,30,1
630332,CHILD'S SOFT TOY/TEDDY BEAR,178,0,20,198,10,10,1
630336,FOOTBALL,131,0,10,141,14.995314,16,1.001
630340,CARBON FIBRE FISHING ROD,67,0,16,83,54.655987,39.990002,1
630341,PRESCHOOL ACTIVITY TOY,161,0,12,173,10.999084,10,1
630342,BEGINNER'S ACOUSTIC GUITAR,76,0,7,83,118.88124,99.989998,1
630343,MEN'S FOOTBALL BOOTS,105,0,13,118,58.983665,60,1
630345,GOLF BALLS PRICE PER BALL,51,60,21,132,1,1,1
630347,CHILD'S BABY DOLL,159,0,12,171,16,15,1
630357,SQUASH/TENNIS RACQUET,124,0,11,135,22.944202,20,1
630358,PORTABLE DIGITAL STORAGE DEVIC,217,0,23,240,10,9.9899998,1
630359,DIGITAL DEVELOPMENT PER PRINT,7,110,8,125,.55000001,.55000001,1.008
630365,CRAFT KIT FOR CHILD 5 YRS+,194,0,24,218,10,8.4799995,.94999999
630368,ELECTRONIC EDUCATIONAL TOY,181,0,20,201,17.964029,18,1
630369,CHARCOAL BBQ NOT DISPOSABLE,139,0,59,198,38.986134,25,1
630373,JIGSAW MINIMUM 100 PIECES,187,0,23,210,12,10,.875
630374,CHILDS SCOOTER AGE 5-12 YEARS,192,0,23,215,37.796978,30,1
630376,CHILDS SIT & RIDE TOY U'ER 5'S,167,0,31,198,39.990002,32.990002,.935
630377,ACTION CAMERA,87,0,24,111,61.828754,34,.727
630378,COMPUTER GAME 1,29,0,0,29,40,39,.97500002
630379,COMPUTER GAME 2,29,0,0,29,50,20.99,.72100002
630380,COMPUTER GAME 3,29,0,0,29,49.999996,21.99,.60000002
630381,HAND WEIGHTS FOR HOME EXERCISE,184,0,17,201,20.974512,13.99,1
630422,BOOK-REFERENCE (EG ATLAS/DICT),159,0,21,180,11.995638,10,1
630425,BOOK-NON-FICTION-HARD-COVER,207,0,9,216,10,12.99,1.175
630426,BOOK-NON-FICTION-PAPER-BACK,175,0,2,177,7.9919996,8.9899998,1.098
630434,BOOK ILLUSTRATED FOR UNDER 5,175,0,11,186,5.938827,5.9899998,1
630435,BOOK - FICTION - HARD COVER,193,0,3,196,10,14,1.308
630437,BOOK - TEENAGE FICTION,177,0,7,184,6.54918,7.9899998,1.0405
630439,BOOK FICTION P/BACK TOP 10,224,0,4,228,5.9893403,7.2399998,1.113
630440,"CHILDS BOOK, FICTION 6-12YRS",211,0,5,216,5.8900523,6.77,1.075
630505,GARDEN SPADE,137,0,13,150,14.95,14.95,1
630507,HOUSEPLANT,168,0,31,199,5.1867223,4.5,.96399999
630510,POTTING COMPOST,114,2,26,142,4.9899998,5.4000001,1
630518,CUT FLOWERS-CARNATIONS-STEM,18,112,39,169,.66513598,.40000001,1
630519,POTTED SHRUB,87,12,29,128,6.4292779,3.3699999,1
630520,"MOWER ELECTRIC, SPECIFY TYPE",121,0,30,151,80,74.989998,1
630525,PLANT FOOD 800ML-2LT/500G-1.5K,144,0,7,151,4.75,4,1
630526,"SEEDS,PKT,SPEC VAR(SEASONAL)",116,19,25,160,1.85,1.8,1
640212,THEATRE ADULT EVES-FRONT STLLS,23,0,9,32,29.15452,18,1.028
640219,SWIMMING POOL ADM STND ADULT,123,0,0,123,4.8707752,4.9000001,1.006
640222,EXERCISE CLASS UPTO 1HR,115,0,6,121,6.3850689,6.5,1.0319999
640224,TEN-PIN BOWLING PER GAME,117,0,0,117,6.9357977,7,1.028
640226,PRIVATE HEALTH CLUB ANNUAL FEE,96,0,2,98,377.21021,379.5,1.018
640240,LIVERY CHARGES PER WEEK,100,0,0,100,95,96.540001,1
640243,SOFT PLAY SESSION TIME PERIOD,91,0,0,91,5.9338522,6.0999999,1.028
640406,HOTEL 1 NIGHT PRICE,56,0,14,70,69.930069,70,1.1440001
